Papilla_of_tongue	Papilla_of_the_Tongue
Facial_nerve	Facial_Nerve
Mesoderm	Mesoderm
Anterior_longitudinal_ligament	Anterior_Longitudinal_Ligament
Inferior_vesical_artery	Inferior_Vesical_Artery
Subcapsular_lens_epithelium	Subcapsular_Epithelium_of_the_Lens
Tear	Tear
Loose_connective_tissue	Loose_Connective_Tissue
Immune_system	Immune_System
Lymph_node_of_neck	Cervical_Lymph_Node
Coccygeal_nerve	Coccygeal_Nerve
Cardiac_ventricle	Cardiac_Ventricle
Troponin_I	Troponin-I
Pulmonary_artery	Pulmonary_Artery
Syncytiotrophoblast_cell	Syncytiotrophoblastic_Cell
Chief_cell_of_stomach	Chief_Cell_of_the_Stomach
Axial	Axial
Troponin_T	Troponin_T
Upper_lobe_of_lung	Lung_Upper_Lobe
Calcium_binding_protein	Calcium_Binding_Protein
Sacrococcygeal_joint	Sacrococcygeal_Joint
Ureter	Ureter
Ameloblast	Ameloblast
Stapes	Stapes
Pulmonary_trunk	Pulmonary_Artery
Shoulder	Shoulder
Iliolumbar_vein	Iliolumbar_Vein
Umbilicus	Umbilical_Region
Carpal_bone	Carpal_Bone
Pectoralis_minor	Pectoralis_Minor
Adventitial_cell	Pericyte
Head_of_pancreas	Head_of_the_Pancreas
Brain	Ventricle_Brain
Brain	Brain
Sertoli_cell	Sertoli_Cell
Wrist_joint	Wrist_Joint
Left_ureter	Left_Ureter
Norepinephrine	Norepinephrine_Base
Norepinephrine	Norepinephrine
Peritoneal_cavity	Peritoneal_Cavity
Minor_salivary_gland	Minor_Salivary_Gland
Frontal_lobe	Frontal_Lobe
Mesothelial_cell	Mesothelial_Cell
Interventricular_septum	Interventricular_Septum
Continuous_capillary	Continuous_Capillary
Eosinophil	Eosinophil
Mitochondrial_crista	Mitochondrial_Crista
Gas	Gas
Larynx	Larynx
Seventh_thoracic_vertebra	T7_Vertebra
Anterior_surface_of_stomach	Anterior_Surface_of_the_Stomach
Superior	Superior_Sagittal_Sinus
Superior	Superior
Portion_of_cytosol	Cytoplasmic_Matrix
Portion_of_cytosol	Cytosol
Periosteal_cell	Periosteal_Cell
Fissure	Fissure
Tonsillar_fossa	Tonsillar_Fossa
Lateral_geniculate_body	External_Geniculate_Body
Endometrium	Endometrium
Dendritic_cell	Dendritic_Cell
Clavicle	Clavicle
External_capsule	External_Capsule
Bronchus	Bronchus
Mitochondrion	Mitochondrion
Aggregated_lymphoid_follicle_of_small_intestine	Peyer_s_Patch
Lipoprotein	Lipoprotein
Thoracic_ganglion	Thoracic_Ganglion
Fundus_of_gallbladder	Gallbladder_Fundus
Tarsal_plate_of_eyelid	Tarsal_Plate
Pericardiacophrenic_vein	Pericardiacophrenic_Vein
Megakaryocyte	Megakaryocyte
Parieto_occipital_sulcus	Parieto-occipital_Fissure
Parieto_occipital_sulcus	Parieto-occipital_Sulcus
Umbilical_artery	Umbilical_Artery
Axoaxonic_synapse	Axoaxonic_Synapse
Gut_associated_lymphoid_tissue	Gut_Associated_Lymphoid_Tissue
Radial_nerve	Radial_Nerve
Cranial	Cranial
Nodular_lymphoid_tissue	Lymphoid_Follicle
Outer_segment_of_rod_cell	Rod_Outer_Segment
Glutamine	Glutamine
Wall_of_prostatic_duct	Wall_of_Human_Prostatic_Duct
Roof_of_fourth_ventricle	Roof_of_the_Fourth_Ventricle
Tract_of_spinal_cord	Spinal_Cord_Tract
Parietal_pleura	Parietal_Pleura
Gonadotroph	Gonadotroph_Cell
Gonadotroph	Gonadotrope_Cell
Lateral_cerebellomedullary_cistern	Inferior_Cerebellopontine_Cistern
Secretin	Secretin
Anterior_jugular_vein	Anterior_Jugular_Vein
Vestibular_nerve	Vestibular_Nerve
Inferior_hypophysial_artery	Inferior_Hypophyseal_Artery
Metatarsal_bone	Metatarsal_Bone
Mediastinal_lymph_node	Mediastinal_Lymph_Node
Fundus_of_stomach	Fundus_of_the_Stomach
Patella	Patella
Microtubule_triplet	Microtubule_Triplet
Hilum	Hilum
Dura_mater	Dura_Mater
Blastocyst	Blastocyst
External_iliac_artery	External_Iliac_Artery
Chromaffin_cell	Chromaffin_Cell
Spinal_ganglion	Dorsal_Root_Ganglion
Set_of_phalanges_of_hand	Hand_Phalanx
Set_of_phalanges_of_hand	Phalanx_of_the_Hand
Pectoral_girdle	Shoulder_Girdle
Interstitial_cell_of_Leydig	Leydig_Cell
Left_brachiocephalic_vein	Left_Innominate_Vein
Left_brachiocephalic_vein	Left_Brachiocephalic_Vein
Anal_column	Anal_Column
Lacrimal_canaliculus	Lacrimal_Canaliculus
Bile	Bile
Supra_orbital_vein	Supra-orbital_Vein
Blastomere	Embryonic_Cell
Blastomere	Blastomere
Levator_palpebrae_superioris	Levator_Palpebrae_Superioris
Anal_canal	Anal_Canal
Greater_trochanter	Great_Trochanter
Middle_cerebral_artery	Middle_Cerebral_Artery
Nerve_plexus	Nerve_Plexus
Teres_major	Teres_Major_Muscle
Ependymal_cell	Ependymocyte
Ependymal_cell	Ependymal_Cell
Tooth	Tooth
Ejaculatory_duct	Ejaculatory_Duct
Postcentral_sulcus	Postcentral_Sulcus
Salpingopharyngeus	Salpingopharyngeus
Cerebral_aqueduct	Cerebral_Aqueduct
Cerebral_aqueduct	Aqueduct_of_Sylvius
Basal_lamina	Basal_Lamina
Endometrial_stroma	Endometrial_Stroma
Hip_bone	Pelvic_Bone
Histamine	Histamine
Adherens_junction	Anchoring_Junction
Adherens_junction	Zonula_Adherens
Appendix	Vermiform_Appendix
Hypothalamus	Hypothalamus
Branch_of_ulnar_artery	Ulnar_Artery_Branch
Orifice_of_auditory_tube	Orifice_of_the_Eustachian_Tube
Internal_jugular_vein	Internal_Jugular_Vein
Mesothelial_cell_of_pleura	Pleural_Mesothelial_Cell
Lower_lobe_of_right_lung	Lower_Lobe_of_the_Right_Lung
Cranial_nerve	Cranial_Nerve
Anus	Anus
Elastin_fiber	Elastin_Fiber
Smooth_muscle_cell	Smooth_Muscle_Tissue_Cell
Fovea_centralis	Fovea_Centralis
Twelfth_thoracic_vertebra	T12_Vertebra
Macula_lutea	Macula
Macula_lutea	Macula_Lutea
Bone_marrow	Bone_Marrow
Hand	Hand
Chief_cell	Chief_Cell
Midbrain	Mesencephalon
Scaphoid	Scaphoid_Bone
Reticular_cell	Reticular_Cell
Osteoid	Osteoid
Third_cervical_vertebra	C3_Vertebra
Loop_of_Henle	Loop_of_Henle
Hemisphere_of_cerebellum	Hemisphere_of_the_Cerebellum
Gracilis	Gracilis
Periodontium	Periodontium
Endothelium_of_lymphatic_vessel	Lymphatic_Vessel_Endothelium
Disaccharide	Disaccharide
Elbow_joint	Elbow_Joint
Type_G_enteroendocrine_cell	G-Cell
External_supporting_cell_of_organ_of_Corti	Supporting_Cell_of_Organ_of_Corti
External_supporting_cell_of_organ_of_Corti	Outer_Supporting_Cell
Pericyte	Pericyte
Glandular_cell_of_small_intestine	Small_Intestinal_Glandular_Cell
Right_testicular_vein	Right_Spermatic_Vein
Endothelium_of_vein	Vein_Endothelium
Musculoskeletal_system	Musculoskeletal_System
Muscle_of_tongue	Tongue_Muscle
Melanocyte	Melanocyte
Late_endosome	Late_Endosome
Gamma_motor_neuron	Gamma_Motor_Neuron
Right_ventricle	Right_Ventricle
Portion_of_tissue	Tissue
Physical_state	Physical_State
Palatoglossus	Palatoglossus_Muscle
Caudal	Caudal
White_pulp_of_spleen	Splenic_White_Pulp
Left_kidney	Left_Kidney
Chondrocranium	Chondrocranium
Left	Left
Lens	Crystalline_Lens
Brachialis	Brachialis
Upper_eyelid	Upper_Eyelid
Ascending_aorta	Ascending_Aorta
Choroid_plexus_of_fourth_ventricle	Choroid_Plexus_of_the_Fourth_Ventricle
Pulmonary_acinus	Pulmonary_Acinus
Mucosa_of_large_intestine	Large_Intestinal_Mucosa
Major_histocompatibility_complex_gene	Major_Histocompatibility_Complex_Gene
Portal_lobule	Portal_Lobule
Fascia_lata	Fascia_Lata
Cricotracheal_ligament	Cricotracheal_Ligament
Extrahepatic_bile_duct	Extrahepatic_Bile_Duct
Platelet	Platelet
Maxillary_sinus	Maxillary_Sinus
Submucosa_of_bronchus	Bronchus_Submucosa
Stereocilium	Stereocilium
Neuropil	Neuropil
Thymus	Thymus
Thymus	Thymus_Gland
Anterior_cerebellar_incisure	Posterior_Supratentorial_Cistern
Branch_of_posterior_cerebral_artery	Posterior_Cerebral_Artery_Branch
Membranous_cytoplasmic_organelle	Membranous_Cytoplasmic_Organelle
Lacrimal_apparatus	Lacrimal_Apparatus
Serine	Serine
Body_of_epididymis	Body_of_the_Epididymis
Fetus	Fetus
Special_sense_organ_system	Special_Sense_Organ_System
Cement	Cementum
Joint	Joint
Joint	Arthropathy
Hepatic_portal_vein	Portal_Vein
Sural_artery	External_Sural_Artery
Actin	Actin
Inferolateral_surface_of_prostate	Inferolateral_Surface_of_the_Prostate
Sublingual_artery	Sublingual_Artery
Fusiform_gyrus	Occipital-temporal_Gyrus
Histidine	Histidine
Keratinized_squamous_cell_of_esophagus	Esophageal_Squamous_Cell
Longus_colli	Longus_Colli
Posterior_temporal_artery	Posterior_Temporal_Artery
Calcarine_sulcus	Calcarine_Sulcus
Nuclear_matrix	Nuclear_Matrix
Oropharynx	Oropharynx
Anal_part_of_perineum	Anal_Region
Common_iliac_lymph_node	Iliac_Lymph_Node
Epididymis	Epididymis
Urinary_bladder	Bladder
Efferent_ductule	Efferent_Ductule
Maxilla	Maxilla
Ductus_arteriosus	Ductus_Arteriosus
Oligodendroglia	Oligodendroglia_Cell
Anterior_surface_of_liver	Anterior_Surface_of_the_Liver
Helicotrema	Helicotrema
Posterior_meningeal_artery	Posterior_Meningeal_Artery
Fourth_sacral_vertebra	S4_Vertebra
Neck_of_urinary_bladder	Bladder_Neck
Beta_adrenergic_receptor	Beta_Adrenergic_Receptor
Mucosa_of_lower_lip	Mucosa_of_the_Lower_Lip
Flexor_carpi_ulnaris	Flexor_Carpi_Ulnaris
Orbital_sulcus	Orbital_Sulcus
Entactin	Nidogen
Superficial_fascia	Subcutis
Superficial_fascia	Superficial_Fascia
Bone_of_trapezoid	Trapezoid_Bone
Deep_circumflex_iliac_artery	Deep_Circumflex_Iliac_Artery
Sex_chromosome	Sex_Chromosome
Papillary_muscle	Papillary_Muscle
Inferior_mesenteric_vein	Inferior_Mesenteric_Vein
Bowman_s_space	Urinary_Space
Bile_duct	Bile_Duct
Musculature_of_face	Facial_Muscle
Outer_nuclear_membrane	Nuclear_Outer_Membrane
Superior_vena_cava	Superior_Vena_Cava
Rectum	Rectum
Glandular_cell_of_large_intestine	Large_Intestinal_Glandular_Cell
Granulosa_cell_of_ovary	Granulosa_Cell
Brachial_vein	Brachial_Vein
Ectocervix	Ectocervix
Right_ovary	Right_Ovary
Chondrocyte	Cartilage_Cell
Chondrocyte	Chondrocyte
Organelle	Cytoplasmic_Organelle
Cerebellum	Cerebellum
Abductor_pollicis_longus	Abductor_Pollicis_Longus
Sebaceous_gland	Sebaceous_Gland
Golgi_complex	Golgi_Apparatus
Oligodendrocyte	Oligodendroglia_Cell
Endothelial_cell	Endothelial_Cell
Head_of_epididymis	Head_of_the_Epididymis
Parametrium	Parametrium
Thoracic_part_of_esophagus	Thoracic_Esophagus
Methionine	Methionine
Diencephalon	Diencephalon
Band_cell	Band_Cell
Splenic_artery	Splenic_Artery
Sphincter_of_hepatopancreatic_ampulla	Sphincter_of_Oddi
Pulmonary_lobule	Pulmonary_Lobule
Synovial_fluid	Synovial_Fluid
Ribosome	Ribosome
Intercalated_disc	Intercalated_Disk
Basophil_cell	Basophilic_Cell
Apex_of_prostate	Apex_of_the_Prostate
Tuberculum_sellae	Tuberculum_Sellae
Dorsal_metatarsal_vein	Dorsal_Metatarsal_Vein
Renal_interstitial_cell	Renal_Interstitial_Cell
Lumbar_nerve_plexus	Lumbar_Plexus
Exocrine_gland	Exocrine_Gland
Tail_of_spermatozoon	Tail_of_the_Spermatozoon
Pupil	Pupil
Root_of_tooth	Radix_Dentis
Subclavius	Subclavius
Lower_eyelid	Lower_Eyelid
Alveolar_epithelial_cell	Alveolar_Cell
Epimysium	Epimysium
Descending_limb_of_loop_of_Henle	Descending_Limb_of_the_Henle_s_Loop
Inferior_thyroid_artery	Inferior_Thyroid_Artery
Glomerulus	Glomerulus
Fibula	Fibula
Vulva	Vulva
Myelinated_nerve_fiber	Myelinated_Nerve_Fiber
Primary_oocyte	Primary_Oocyte
Acidophil_cell	Acidophilic_Cell
Great_cardiac_vein	Great_Cardiac_Vein
Ophthalmic_nerve	Ophthalmic_Nerve
Acetabular_part_of_hip_bone	Acetabulum
Mucosa_of_small_intestine	Small_Intestinal_Mucosa
Placenta	Placenta
Solitary_tract_nuclear_complex	Solitary_Nucleus
Median_thyrohyoid_ligament	Middle_Thyrohyoid_Ligament
Tubulin	Tubulin
Vertebral_canal	Vertebral_Canal
Monocyte	Monocyte
Neutrophil	Neutrophil
Scalenus_medius	Scalenus_Medius
Centrosome	Centrosome
Blood_cell	Peripheral_Blood_Cell
Inferior_nasal_concha	Inferior_Turbinate
Nucleoporin	Nucleoporin
Oocyte	Egg
Oocyte	Oocyte
Vestibular_nucleus	Vestibular_Nucleus
Metatarsophalangeal_joint	Metatarsophalangeal_Joint
Visual_system	Visual_System
Hemopoietic_tissue	Hematopoietic_Tissue
Coronary_ligament	Coronary_Ligament
Incus	Incus
Ligament_of_liver	Liver_Ligament
Plus_end_of_microtubule	Plus_End_of_the_Microtubule
Cusp	Cusp
Tunica_intima	Tunica_Intima
Epithelium_of_oropharynx	Oropharynx_Epithelium
Right_common_iliac_artery	Right_Common_Iliac_Artery
Peritoneum	Peritoneum
Left_renal_artery	Left_Renal_Artery
Pectineus	Pectineus
Sensory_ganglion	Sensory_Ganglion
Myo_inositol	Inositol
Hippocampus	Hippocampus
Hippocampus	Cornu_Ammonis
Duct_of_epididymis	Duct_of_the_Epididymis
Fibrous_capsule_of_spleen	Bowman_s_Capsule
Fibrous_capsule_of_spleen	Splenic_Capsule
Appendicular_skeleton	Appendicular_Skeleton
Lingual_artery	Lingual_Artery
Upper_gastrointestinal_tract	Upper_Gastrointestinal_Tract
Superior_thyroid_artery	Superior_Thyroid_Artery
Volume	Publication_Volume
Volume	Volume
Submandibular_duct	Submandibular_Duct
Callosomarginal_artery	Callosomarginal_Artery
Coronary_artery	Coronary_Artery
Woven_bone	Immature_Bone
Deep_vein	Deep_Vein
Cardiovascular_system	Cardiovascular_System
Feces	Feces
Posterior_surface_of_prostate	Posterior_Surface_of_the_Prostate
Superior_vesical_artery	Superior_Vesical_Artery
Semicircular_canal	Semicircular_Canal
Layer_of_retina	Retina_Layer
Prepuce_of_clitoris	Female_Prepuce
Squamous_cell_of_ectocervix	Ectocervical_Squamous_Cell
Iliacus	Iliacus
Finger	Finger
Megakaryoblast	Megakaryoblast
Compact_bone	Cortical_Bone
Skin_of_eyelid	Eyelid_Skin
Blood_vessel	Blood_Vessel
Ciliary_process	Ciliary_Process
Prostatic_urethra	Prostatic_Portion_of_the_Male_Urethra
Peripheral_nervous_system	Peripheral_Nervous_System
Septum_pellucidum	Septum_Pellucidum
Mammotroph	Lactotrope_Cell
Fibroblast	Fibroblast
Mylohyoid	Mylohyoid
Axillary_nerve	Axillary_Nerve
Postcentral_gyrus	Postcentral_Gyrus
Longitudinal	Longitudinal
Cadherin	Cadherin
Portal_vein	Portal_Vein
Thymosin	Thymosin
Urine	Urine
Cardiac_valve	Cardiac_Valve
Abdominal_part_of_esophagus	Abdominal_Esophagus
Gland	Gland
Collateral_sulcus	Collateral_Sulcus
Collateral_sulcus	Collateral_Fissure
Viscus	Viscera
Type_2_vestibular_sensory_cell	Type_II_Hair_Cell
Mesangial_cell	Mesangial_Cell
Glomerular_capsule	Bowman_s_Capsule
Right_suprarenal_vein	Right_Suprarenal_Vein
Hip	Ischium
Hip	Hip
Uvula	Uvula
Endoneurium	Endoneurium
Intestinal_epithelium	Intestinal_Epithelium
Atlanto_occipital_joint	Atlanto-occipital_Joint
Carbohydrate	Carbohydrate
Decidua_basalis	Decidua_Basalis
Buccal_mucosa	Buccal_Mucosa
Ependyma_of_lateral_ventricle	Lateral_Ventricle_Ependyma
Thyroidea_ima_artery__variant_	Thyroid_Ima_Artery
Renal_pyramid	Renal_Pyramid
Central_sulcus	Central_Sulcus_of_Rolando
Central_sulcus	Sulcus_Centralis
Mons_pubis	Mons_Pubis
Basal_cell_of_olfactory_epithelium	Olfactory_Basal_Cell
Centromere	Centromere
External_ear	External_Ear
Trabecula_of_spleen	Splenic_Trabecula
Inferior_frontal_sulcus	Inferior_Frontal_Sulcus
Masticatory_muscle	Masseter_Muscle
Haversian_canal	Haversian_Canal
Solid	Solid
Quadrate_lobe_of_liver	Lobus_Quadratus
Heparan_sulfate_proteoglycan	Heparan_Sulfate_Proteoglycan
Lung_parenchyma	Lung_Tissue
Muscle_of_palate	Palatal_Muscle
Hepatic_vein	Hepatic_Vein
Ependyma_of_fourth_ventricle	Fourth_Ventricle_Ependyma
Perilymph	Perilymph
Synaptic_cleft	Synaptic_Cleft
Canine_tooth	Canine_Tooth
Temporal_bone	Temporal_Bone
Fourth_cervical_vertebra	C4_Vertebra
Right_cerebral_hemisphere	Right_Cerebral_Hemisphere
Hamate	Hamate_Bone
Free_ribosome	Free_Ribosome
Deep_middle_cerebral_vein	Deep_Middle_Cerebral_Vein
Surface_of_prostate	Surface_of_the_Prostate
Glandular_cell_of_esophagus	Esophageal_Glandular_Cell
Embryonic_structure	Embryonic_Structure
Bulbus_cordis	Bulbus_Cordis
Deep_brachial_artery	Superior_Profunda_Artery
Hyoglossus	Hyoglossus_Muscle
Amniotic_cavity	Amniotic_Cavity
Proximal_phalanx_of_finger	Proximal_Phalanx_of_the_Hand
Proximal_phalanx_of_finger	Proximal_Phalanx_of_Hand
Celiac_artery	Coeliac_Artery
Axis	C2_Vertebra
Olfactory_sulcus	Olfactory_Sulcus
Primitive_erythroblast	Basophilic_Erythroblast
Ligament_of_larynx	Laryngeal_Ligament
Squamous_cell_of_epidermis	Skin_Squamous_Cell
Sympathetic_nervous_system	Sympathetic_Nervous_System
Plus_end_of_actin_filament	Plus_End_of_the_Actin_Filament
Anterolateral	Anterolateral
Adenohypophysis	Anterior_Lobe_of_the_Pituitary_Gland
Adenohypophysis	Pituitary_Gland
Aspartic_acid	Aspartic_Acid
Chief_cell_of_parathyroid_gland	Parathyroid_Gland_Chief_Cell
Medial_frontobasal_artery	Medial_Orbitofrontal_Artery
Histiocyte	Histiocyte
Histiocyte	Macrophage
Splenium_of_corpus_callosum	Splenium_of_the_Corpus_Callosum
Pleura	Pleural_Tissue
Vasoactive_intestinal_peptide	Vasoactive_Intestinal_Peptide
Arcuate_nucleus_of_hypothalamus	Arcuate_Nucleus
Pronephros	Pronephros
Right_lymphatic_duct	Right_Lymphatic_Duct
Soft_palate	Soft_Palate
Set_of_neuroglial_cells	Glial_Cell
Angular_gyrus	Angular_Gyrus
Glottis	Glottis
Optic_disc	Optic_Disc
Descending_part_of_duodenum	Second_Portion_of_the_Duodenum
Cube	Cube
Embryo	Embryo
Neuroendocrine_cell	Neuroendocrine_Cell
Umbilical_fissure	Umbilical_Fissure
Peduncle_of_midbrain	Cerebral_Peduncle
Atlas	C1_Vertebra
Milk	Milk
Venule	Venule
Skeletal_muscle_tissue	Skeletal_Muscle_Tissue
Blast_cell	Blast_Cell
Spinalis_thoracis	Spinalis_Thoracis
Corticotroph	Corticotrope_Cell
Corticotroph	Corticotroph_Cell
Posterior_surface_of_liver	Posterior_Surface_of_the_Liver
Cylinder	Cylinder
First_sacral_vertebra	S1_Vertebra
Bile_canaliculus	Bile_Canaliculus
Ependyma_of_neuraxis	Ependyma
Rectus_femoris	Rectus_Femoris
Head_of_spermatozoon	Head_of_the_Spermatozoon
Central_canal_of_spinal_cord	Central_Canal
External_intercostal_muscle	External_Intercostal_Muscle
Accessory_pancreatic_duct	Ductus_Santorini
Biceps_femoris	Biceps_Femoris
Laryngeal_ventricle	Laryngeal_Ventricle
Ribosomal_ribonucleic_acid	Ribosomal_RNA
Superficial_circumflex_iliac_artery	Superficial_Circumflex_Iliac_Artery
Glucose	Hypoglycemia
Glucose	Glucose
Meningothelial_cell	Meningothelial_Cell
Acromion	Acromion
Right_atrium	Right_Atrium
Crico_arytenoid_joint	Cricoarytenoid_Joint
Branch_of_vertebral_artery	Vertebral_Artery_Branch
Canal_for_tensor_tympani	Canal_for_Tensor_Tympani
Nipple	Nipple
Cytoskeletal_protein	Cytoskeletal_Protein
Pleural_cavity	Pleural_Cavity
Carpometacarpal_joint	Carpometacarpal_Joint
Photoreceptor_cell	Photoreceptor_Cell
Superior_frontal_sulcus	Superior_Frontal_Sulcus
Extraembryonic_celom	Extraembryonic_Coelom
Median_aperture_of_fourth_ventricle	Foramen_of_Magendie
Ectoderm	Ectoderm
Anterior_surface_of_kidney	Anterior_Surface_of_the_Kidney
Jejunum	Jejunum
Anterior_pole_of_lens	Anterior_Pole_of_the_Lens
Giant_cell	Giant_Cell
Giant_cell	Giant_Cell_Carcinoma
Unencapsulated_nerve_ending	Free_Nerve_Ending
Long_bone	Long_Bone
Nongranular_leukocyte	Non-Granular_Leukocyte
Cavernous_sinus	Cavernous_Sinus
Canal_of_Volkmann	Perforating_Canal
Acinar_cell	Acinar_Cell
Phalanx_of_toe	Phalanx_of_the_Foot
Phalanx_of_toe	Foot_Phalanx
Caudate_lobe_of_liver	Lobus_Caudatus
Processus_cochleariformis	Processus_Cochleariformis
Ulnar_artery	Ulnar_Artery
Islet_cell	Islet_Cell
Amino_acid	Amino_Acid
Amino_acid	Amino_Acid_Peptide_or_Protein
Lamina_propria	Lamina_Propria
Trochanter	Trochanter
Intercalated_cell_of_collecting_duct_of_renal_tubule	Type_I_Cell
Intercalated_cell_of_collecting_duct_of_renal_tubule	Intercalated_Cell
Ductus_venosus	Ductus_Venosus
Stylopharyngeus	Stylopharyngeus
Endothelium_of_artery	Artery_Endothelium
Cheek	Cheek
Faceted_volume	Polyhedron
Cerebral_cortex	Cortex
Bone_of_radius	Radius_Bone
Guanine	Guanine
Enterocyte	Enterocyte
Pancreatic_acinus	Pancreatic_Acinus
Cell_morphology	Cellular_Morphology
Interleukin_12B	Interleukin-12B
Interleukin_12A	Interleukin-12A
Eyelash	Eyelash
Forebrain	Fore-Brain
Forebrain	Prosencephalon
Esophageal_gland	Esophageal_Gland
Pharyngeal_tonsil	Pharyngeal_Tonsil
Trigone_of_urinary_bladder	Bladder_Trigone
Body_surface	Body_Surface
Branch_of_anterior_cerebral_artery	Anterior_Cerebral_Artery_Branch
Goblet_cell_of_small_intestine	Small_Intestinal_Goblet_Cell
Surface	Surface
Posterior_communicating_artery	Posterior_Communicating_Artery
Second_sacral_vertebra	S2_Vertebra
Space_of_Mall	Space_of_Mall
Superficial_cervical_artery	Superficial_Cervical_Artery
Esophagogastric_junction	Gastroesophageal_Junction
Zygomatic_arch	Zygomatic_Arch
Corpus_callosum	Corpus_Callosum
Peripheral_blood_mononuclear_cell	Peripheral_Blood_Mononuclear_Cell
Sesamoid_bone	Sesamoid_Bone
Commissure	Commissure
Portion_of_epithelium	Epithelium
Portion_of_epithelium	Epithelial_Tissue
Pinealocyte	Pinealocyte
T_lymphocyte	Helper-Inducer_T-Lymphocyte
T_lymphocyte	T-Lymphocyte
Transitional_epithelium_of_urinary_bladder	Bladder_Transitional_Cell_Epithelium
Posterior_limiting_lamina_of_cornea	Descemet_s_Membrane
Mesonephros	Mesonephros
Right_lobe_of_thyroid_gland	Right_Thyroid_Gland_Lobe
Keratinized_cell_of_epidermis	Keratinocyte
Triangular_ligament	Triangular_Ligament
Pancreatic_islet	Islet_of_Langerhans
Prostatic_duct	Prostatic_Duct
Deep_lymphatic_vessel	Deep_Lymphatic_Vessel
Sella_turcica	Sella_Turcica
Phosphatidylserine	Phosphatidylserine
Mucosa_of_stomach	Gastric_Mucosa
Cephalic_vein	Cephalic_Vein
Cochlea	Cochlea
Lateral_lobe_of_prostate	Lateral_Lobe_of_the_Prostate
Ileum	Ileum
Great_cerebral_vein	Great_Cerebral_Vein_of_Galen
Small_saphenous_vein	Short_Saphenous_Vein
Interphase_chromosome	Interphase_Chromosome
Unipolar_neuron	Unipolar_Neuron
Spinal_cord	Spinal_Cord
Apex_of_tongue	Apex_of_the_Tongue
Female_breast	Female_Breast
Abdominal_cavity	Abdominal_Cavity
Parietal_bone	Parietal_Bone
Palpebral_conjunctiva	Palpebral_Conjunctiva
Ileal_diverticulum	Meckel_Diverticulum
Protein	Protein
Protein	Protein_Organized_by_Function
Posterior_surface_of_stomach	Posterior_Surface_of_the_Stomach
Thymine	Thymine
Nucleus_of_solitary_tract	Nucleus_of_the_Solitary_Tract
Nuclear_lamin	Nuclear_Lamin
Plasma_cell	Plasma_Cell
Capsule_of_parathyroid_gland	Parathyroid_Gland_Capsule
Left_testicular_artery	Left_Spermatic_Artery
Secretory_cell	Secretory_Cell
Extracellular_space	Extracellular_Space
Metaphysis	Metaphysis
Adipocyte	Adipocyte
Adipocyte	Lipocyte
Nucleoplasm	Nucleoplasm
Crest	Crest
Crest	Ridge
Mandibular_nerve	Inferior_Maxillary_Nerve
Eyelid	Eyelid
Pyloric_sphincter	Pyloric_Sphincter
Buccal_artery	Buccal_Artery
Splenial_artery	Splenial_Artery
Fibrillar_actin	F-actin
Motor_neuron	Motor_Neuron
Suppressor_inducer_T_lymphocyte	Suppressor-Inducer_T-Lymphocyte
Palate	Palate
Cardiac_vein	Cardiac_Vein
Middle_cranial_fossa	Middle_Fossa
Ribonucleic_Acid	Ribonucleic_Acid
Suprarenal_vein	Suprarenal_Vein
Fourth_thoracic_vertebra	T4_Vertebra
T_cytotoxic_cell	Cytotoxic_T-Lymphocyte
Cellulose	Cellulose
Dermis	Dermis
Melatonin	Therapeutic_Melatonin
Melatonin	Melatonin
Basement_membrane	Basement_Membrane
Costal_arch	Costal_Arch
Popliteal_lymph_node	Popliteal_Lymph_Node
Lymph	Lymph
Cilium	Cilium
Gonad	Gonad
Oculomotor_nuclear_complex	Oculomotor_Nucleus
Follicular_cell_of_ovary	Follicular_Ovarian_Cell
Lamina_lucida	Lamina_Lucida
Common_carotid_artery	Carotid_Artery
Common_carotid_artery	Common_Carotid_Artery
Internal_carotid_nerve_plexus	Internal_Carotid_Nerve_Plexus
Cauda_equina	Cauda_Equina
Myofilament	Myofilament
Biliary_system	Biliary_Tract
Male_breast	Male_Breast
Isthmus_of_thyroid_gland	Thyroid_Gland_Isthmus
Iliolumbar_artery	Iliolumbar_Artery
Superior_anastomotic_vein	Superior_Anastomotic_Vein_of_the_Trolard
Eighth_thoracic_vertebra	T8_Vertebra
Cystic_vein	Cystic_Vein
Subscapular_artery	Subscapular_Artery
Nonsynovial_joint	Synarthrosis
Nuclear_pore_complex	Nuclear_Pore_Complex
Corneal_endothelium	Corneal_Endothelium
Portion_of_connective_tissue	Connective_Tissue_Disorder
Portion_of_connective_tissue	Connective_Tissue
Anterior_semicircular_canal	Superior_Semicircular_Canal
Ischiocavernosus	Ischiocavernosus
Lingual_salivary_gland	Lingual_Salivary_Gland
Renal_papilla	Renal_Papilla
Substantia_gelatinosa	Substantia_Gelatinosa
Peroneal_artery	Peroneal_Artery
Inferior_temporal_sulcus	Inferior_Temporal_Sulcus
Sphenoparietal_sinus	Sphenoparietal_Sinus
Chiasmatic_cistern	Chiasmatic_Cistern
Submucosa_of_small_intestine	Small_Intestinal_Submucosa
Second_thoracic_vertebra	T2_Vertebra
Somatic_nerve_plexus	Spinal_Nerve_Plexus
Primary_tooth	Temporary_Tooth
Lunate_sulcus	Lunate_Sulcus
Ninth_thoracic_vertebra	T9_Vertebra
Semimembranosus	Semimembranosus
Muscle_cell	Muscle_Cell
Neuroblast	Neuroblast
Left_renal_vein	Left_Renal_Vein
Portion_of_neural_tissue	Nervous_Tissue
Portion_of_neural_tissue	Nerve_and_Perineural_Tissue
Pseudostratified_columnar_epithelium	Pseudostratified_Columnar_Epithelium
Right_coronary_artery	Right_Coronary_Artery
Pelvic_lymph_node	Pelvic_Lymph_Node
Psoas_major	Psoas_Major
Superficial_vein	Superficial_Vein
White_matter_of_neuraxis	White_Matter
Thoracic_lymph_node	Thoracic_Lymph_Node
Chorda_tendinea	Chordae_Tendineae
Bronchiolar_non_ciliated_cell	Clara_Cell
Dorsal	Dorsal
Eotaxin_2	CCL24_Gene
Eotaxin_2	Small_Inducible_Cytokine-A24
Eotaxin_3	Small_Inducible_Cytokine-A26
Eotaxin_3	CCL26_Gene
Left_testis	Left_Testis
Celiac_lymph_node	Celiac_Lymph_Node
Lateral_thyrohyoid_ligament	Lateral_Thyrohyoid_Ligament
Aponeurosis	Aponeurosis
Extensor_carpi_ulnaris	Extensor_Carpi_Ulnaris
Pyramidalis	Pyramidalis
CC_chemokine	Beta_Chemokine
Bone_marrow_stem_cell	Bone_Marrow_Stem_Cell
Mucus	Mucus
Upper_lobe_of_left_lung	Upper_Lobe_of_the_Left_Lung
Membranous_urethra	Membranous_Urethra
Ground_substance	Cytoplasmic_Matrix
Ground_substance	Ground_Substance
Serum	Serum
Malleus	Malleus
Sinusoid	Discontinuous_Capillary
Nerve_fiber	Axon
Fifth_thoracic_vertebra	T5_Vertebra
Protoplasmic_astrocyte	Protoplasmic_Astrocyte
Cell_nucleus	Nucleus
Alimentary_system	Gastrointestinal_System
Alimentary_system	Digestive_System
Sacro_iliac_joint	Sacroiliac_Joint
Interstitial_cell	Leydig_Cell
Interstitial_cell	Interstitial_Cell
Lipid_bilayer_of_plasma_membrane	Plasma_Membrane_Lipid_Bilayer
Mucosa_of_urinary_bladder	Bladder_Mucosa
Metacarpal_bone	Metacarpal_Bone
Calcarine_artery	Calcarine_Artery
Fontanelle	Fontanelle
White_adipose_tissue	White_Adipose_Tissue
Surface_ectoderm	Surface_Ectoderm
Medial_plantar_artery	Medial_Plantar_Artery
Electrical_synapse	Electrical_Synapse
Ganglioside	Ganglioside
Nephron	Nephron
Cortex_of_kidney	Renal_Cortex
Pisiform	Pisiform_Bone
Set_of_lumbar_vertebrae	Lumbar_Vertebra
Neck	Neck
Sacral_vertebra	Sacral_Vertebra
Axon	Axon
Flexor_digitorum_longus	Flexor_Digitorum_Longus
Transversus_abdominis	Transversus_Abdominis
Internal_thoracic_vein	Internal_Thoracic_Vein
Superior_cerebellar_artery	Superior_Cerebellar_Artery
Sclera	Sclera
Cytoplasm	Cytoplasm
Pyramidal_cell	Pyramidal_Cell
Fossa	Fossa
Root_of_nail	Root_of_the_Nail
Lymphoblast	Lymphoblast
Purkinje_neuron	Purkinje_s_Cell
Flexor_hallucis_longus	Flexor_Hallucis_Longus
Skin_of_lip	Skin_of_the_Lip
Frontal_sinus	Frontal_Sinus
Villus	Villus
Atrioventricular_node	Atrioventricular_Node
Intercostal_muscle	Intercostal_Muscle
Atrium	Cardiac_Atrium
Periosteum	Periosteum
Glucuronic_acid	Glucuronic_Acid
External	External_Ear
External	External
Trachea	Trachea
Depressor_labii_inferioris	Depressor_Labii_Inferioris
Heart	Heart
Heart	Cardiac_Ventricle
Sarcoplasm	Sarcoplasm
Posterior_mediastinum	Posterior_Mediastinum
Extensor_carpi_radialis_brevis	Extensor_Carpi_Radialis_Brevis
Brachial_artery	Brachial_Artery
Endoderm	Endoderm
Totipotent_neuroepithelial_stem_cell	Totipotent_Neuroepithelial_Stem_Cell
Alveolus	Alveolus
Renal_tubule	Renal_Tubule
Common_bile_duct	Common_Bile_Duct
Anterior_communicating_artery	Anterior_Communicating_Artery
Submucosa_of_stomach	Gastric_Submucosa
Argentaffin_cell	Argentaffin_Cell
Sternoclavicular_joint	Sternoclavicular_Joint
Posterior_surface_of_lens	Facies_Posterior_Lentis
Cortex_of_thymus	Thymus_Cortex
Choroid_plexus_of_third_ventricle	Choroid_Plexus_of_the_Third_Ventricle
Internal_intercostal_muscle	Internal_Intercostal_Muscle
Right_hypochondrium	Right_Hypochondriac_Region
Subcostal_artery	Subcostal_Artery
Endolymph	Endolymph
Clitoris	Clitoris
Genioglossus	Genioglossus
Nissl_body	Nissl_Body
Alveolar_duct	Alveolar_Duct
Skin_of_leg	Leg_Skin
Portal_venous_system	Portal_Venous_System
Gallbladder	Gallbladder
Anterior_tibial_vein	Anterior_Tibial_Vein
Semispinalis_thoracis	Semispinalis_Thoracis
Masseteric_vein	Masseteric_Vein
Internal_carotid_artery	Internal_Carotid_Artery
Stomach	Stomach
Capsule_of_lymph_node	Lymph_Node_Capsule
Astrocyte	Astrocyte
Vestibular_nuclear_complex	Vestibular_Nucleus
Phrenic_nerve	Phrenic_Nerve
Pair_of_lungs	Lung
Longissimus_capitis	Longissimus_Capitis
Mature_sperm_cell	Spermatozoon
Mature_sperm_cell	Male_Genital_System_Fluid_or_Secretion
Scapula	Scapula
Right_inguinal_part_of_abdomen	Right_Inguinal_Region
Crown_of_tooth	Corona_Dentis
Skin_of_hand	Hand_Skin
Exocrine_pancreas	Exocrine_Pancreas
Mucoid_tissue	Mucous_Connective_Tissue
Calcaneal_tendon	Achilles_Tendon
Surface_of_cell	Cell_Surface
Surface_of_cell	Cell_Surface_Receptor
Coccyx	Coccyx
Alpha_adrenergic_receptor	Alpha_Adrenergic_Receptor
Ciliary_body	Ciliary_Body
Third_lumbar_vertebra	L3_Vertebra
Organ	Organ
Cell	Normal_Cell
Cell	Cell
Cell	Cell_Space
Somite	Somite
Elastic_fiber	Elastic_Fiber
Right_lung	Right_Lung
Gluteus_medius	Gluteus_Medius
Trochlear_nerve	Trochlear_Nerve
Eyebrow	Eyebrow
Basal_part_of_pons	Pontine_Base
E_selectin	E-Selectin
Lactiferous_duct	Lactiferous_Duct
Lymphatic_system	Lymphatic_System
Histone_H2A	Histone-H2A
Body_of_gallbladder	Gallbladder_Body
Dorsalis_pedis_artery	Dorsalis_Pedis_Artery
Histone_H2B	Histone-H2B
Actin_filament	Actin_Filament
Submandibular_gland	Submandibular_Gland
Immunoglobulin_A	IgA
Falciform_ligament	Falciform_Ligament
Threonine	Threonine
Aortic_valve	Aortic_Valve
Langerhans_cell	Langerhans_Cell
Set_of_duodenal_glands	Brunner_s_Gland
Ascending_colon	Ascending_Colon
Vermiform_granule	Birbeck_Granule
Abducens_nerve	Abducens_Nerve
Alveolar_sac	Alveolar_Sac
Vomer	Vomer
Intercarpal_joint	Carpal_Joint
Fibrocartilage	Fibrocartilage
Adrenal_cortex	Adrenal_Cortex
Fascial_sheath_of_eyeball	Substantia_Propria
Dorsal_nucleus_of_vagus_nerve	Dorsal_Nucleus_of_the_Vagus_Nerve
Hematopoietic_system	Hematopoietic_System
Interdigitating_dendritic_cell	Interdigitating_Dendritic_Cell
Pineal_body	Pineal_Gland
Epithalamus	Epithalamus
Immunoglobulin_G	IgG
Immunoglobulin_D	IgD
Immunoglobulin_E	IgE
Macula_of_utricle_of_membranous_labyrinth	Macula_of_Utricle
Upper_jaw	Upper_Jaw
Type_IV_collagen	Collagen-IV
Skin_of_wrist	Wrist_Skin
Submucosa_of_trachea	Trachea_Submucosa
Immunoglobulin_M	IgM
Crypt_of_Lieberkuhn_of_small_intestine	Small_Intestinal_Crypt_of_Lieberkuhn
Chromatid	Chromatid
Proerythroblast	Proerythroblast
Chromatin	Chromatin
Supraclavicular_lymph_node	Supraclavicular_Lymph_Node
Cementoblast	Cementoblast
Patellar_ligament	Patellar_Ligament
Extensor_carpi_radialis_longus	Extensor_Carpi_Radialis_Longus
Lower_uterine_segment	Isthmus_Uteri
Vertebra	Vertebra
Central_tendon	Central_Tendon_of_the_Diaphragm
Subcostal_vein	Subcostal_Vein
Lutropin	Therapeutic_Luteinizing_Hormone
Lutropin	Luteinizing_Hormone
Thymocyte	Thymocyte
Axodendritic_synapse	Axodendritic_Synapse
Eyeball	Eye
Lumbar_artery	Lumbar_Artery
Femur	Femur
Keratin_filament	Keratin_Filament
Hepatogastric_ligament	Hepatogastric_Ligament
Carina_of_trachea	Carina
Muscle_of_pharynx	Pharyngeal_Muscle
Follitropin	Follicle_Stimulating_Hormone
Follitropin	Folitropin
Follitropin	Therapeutic_Follicle_Stimulating_Hormone
Embryonic_stem_cell	Embryonic_Stem_Cell
Endothelium_of_capillary	Capillary_Endothelium
Decidua_capsularis	Decidua_Capsularis
Tendinous_cuff	Rotator_Cuff
Humerus	Humerus
Glomerular_basement_membrane	Glomerular_Basement_Membrane
Episcleral_layer_of_eyeball	Episclera
Falx_cerebri	Falx_Cerebri
Thrombospondin	Thrombospondin
Flexor_carpi_radialis	Flexor_Carpi_Radialis
Anocutaneous_line	Anocutaneous_Line
Pituitary_gland	Anterior_Lobe_of_the_Pituitary_Gland
Pituitary_gland	Pituitary_Gland
Ovary	Ovary
Secondary_oocyte	Secondary_Oocyte
Arm	Arm
Omentum	Omentum
Cerebral_white_matter	Cerebral_White_Matter
Striated_border	Striated_Border
Occipital_artery	Occipital_Artery
Rough_endoplasmic_reticulum	Rough_Endoplasmic_Reticulum
Zygomaticus_major	Zygomaticus_Major
Soleus	Soleus
Left_lung	Left_Lung
Protoplasm	Protoplasm
Endosteum	Endosteum
Submucosa	Submucosa
Cerebellomedullary_cistern	Cisterna_Magna
Fenestrated_capillary	Fenestrated_Capillary
Interstitial_cell_of_pineal_gland	Interstitial_Cell_of_the_Pineal_Gland
Lower_jaw	Lower_Jaw
Thyroepiglotticus	Thyroepiglottic_Muscle
Lamina_densa	Basal_Lamina
Lamina_densa	Lamina_Densa
Branch_of_middle_cerebral_artery	Middle_Cerebral_Artery_Branch
Mannose	Mannose
Muscle_spindle	Muscle_Spindle
Type_I_cell_of_carotid_body	Glomus_Cell
Epithelium_of_choroid_plexus	Choroid_Plexus_Epithelium
Ciliated_columnar_cell_of_tracheobronchial_tree	Ciliated_Bronchial_Epithelial_Cell
Mediastinum	Mediastinum
Peptide_hormone	Peptide_Hormone
Set_of_tarsal_bones	Tarsal_Bone
Dorsal_nasal_artery	Dorsal_Nasal_Artery
Erythrocyte	Erythrocyte
Multipotent_stem_cell	Multipotent_Stem_Cell
Epidermis	Epidermis
Superficial_palmar_arterial_arch	Superficial_Palmar_Arch
Tyrosine	Tyrosine
Orbiculus_ciliaris	Orbiculus_Ciliaris
Pulmonary_vein	Pulmonary_Vein
Cell_coat	Glycocalyx
Areola	Areola
Metacarpophalangeal_joint	Metacarpophalangeal_Joint
Glucagon	Glucagon
Glucagon	Therapeutic_Glucagon
Left_common_carotid_artery	Left_Common_Carotid_Artery
Ileocecal_valve	Ileocecal_Valve
Mucosa	Mucosa
Mucosa	Mucous_Membrane
Renal_artery	Renal_Artery
Choroid	Choroid
Mitral_valve	Mitral_Valve
Colon	Colon
Parotid_gland	Parotid_Gland
Cardiac_nerve_plexus	Cardiac_Nerve_Plexus
Semispinalis_cervicis	Semispinalis_Cervicis
Rete_testis	Rete_Testis
Left_subclavian_artery	Left_Subclavian_Artery
Cricothyroid_ligament	Cricothyroid_Ligament
Foramen_secundum	Foramen_Secundum
Sweat	Sweat
Crus_of_helical_part_of_auricular_cartilage	Crus_Helicis
Ileal_vein	Ileal_Vein
Conchal_part_of_pinna	Concha
Lateral_ventricle	Lateral_Ventricle
Amygdala	Amygdala
Amygdala	Amygdaloid_Body
Intrahepatic_bile_duct	Intrahepatic_Bile_Duct
Inferior_temporal_gyrus	Inferior_Temporal_Gyrus
Bone_of_pisiform	Pisiform_Bone
Proximal	Proximal
Luminal	Luminal
Nephrogenic_cord	Nephrogenic_Cord
Membrane	Membrane
Membrane	Tympanic_Membrane
Ventral	Ventral
Set_of_bronchi	Bronchus
Unmyelinated_nerve_fiber	Unmyelinated_Nerve_Fiber
Optic_nerve	Optic_Nerve_Neoplasm
Optic_nerve	Optic_Nerve
Kidney	Kidney
Posterior_tibial_vein	Posterior_Tibial_Vein
Primordium	Primordium
Cone	Cone_Shape
Cone	Cone
Follicular_dendritic_cell	Follicular_Dendritic_Cell
Medial_forebrain_bundle	Medial_Forebrain_Bundle
Juxtaglomerular_cell	Juxtaglomerular_Cell
Submucosa_of_large_intestine	Large_Intestinal_Submucosa
Unilaminar_epithelium	Simple_Epithelium
Seminiferous_tubule_of_testis	Seminiferous_Tubule
Anterior_mediastinum	Anterior_Mediastinum
Line	Line
Epithelium_of_bronchiole	Bronchiole_Epithelium
Cerebellopontine_angle	Cerebellopontine_Angle
Putamen	Putamen
Eleventh_thoracic_vertebra	T11_Vertebra
Lateral_occipital_sulcus	Lateral-occipital_Sulcus
Nasal_cavity	Nasal_Cavity
Nose	Nose
Limb	Extremities
Limb	Limb
Thyroid_follicular_cell	Thyroid_Gland_Follicular_Cell
Bone_tissue	Bone_Tissue
Subscapularis	Subscapularis
Thoracic_cavity	Thoracic_Cavity
External_iliac_vein	External_Iliac_Vein
Dental_pulp	Dental_Pulp
Bronchial_tree	Bronchial_Tree
Middle_ear	Ear_Middle_Ear_MMHCC
Middle_ear	Middle_Ear
Pharyngotympanic_tube	Eustachian_Tube
Neuraxis	Central_Nervous_System
Neurofilament	Neurofilament
Epithelium_of_terminal_bronchiole	Terminal_Bronchiole_Epithelium
Infraclavicular_part_of_chest	Infraclavicular_Region
Antitragus	Antitragus
Ascending_limb_of_loop_of_Henle	Ascending_Limb_of_the_Henle_s_Loop
Visceral_pleura	Visceral_Pleura
Adrenal_medulla	Adrenal_Medulla
Bone_of_lunate	Lunate_Bone
Basicranium	Base_of_the_Skull
Glandular_cell_of_endometrium	Endometrial_Cell
Great_saphenous_vein	Long_Saphenous_Vein
Sinuatrial_node	Sinoatrial_Node
Glutamic_acid	Glutamic_Acid
Foot	Foot
Pituicyte	Pituicyte
Endoplasmic_reticulum	Endoplasmic_Reticulum
Cementocyte	Cementocyte
Geniohyoid	Geniohyoid
Axillary_lymph_node	Axillary_Lymph_Node
Left_lobe_of_liver	Left_Lobe_of_the_Liver
Outer_nuclear_layer_of_retina	Outer_Nuclear_Layer_of_Retina
Cerebral_crus	Crus_Cerebri
Dentine	Dentin
Thyro_epiglottic_ligament	Thyroepiglottic_Ligament
Selectin	Selectin
Hemoglobin	Hemoglobin
Vitreous_body	Vitreous_Body
Globular_actin	G-actin
Deep_temporal_vein	Deep_Temporal_Vein
Cytotrophoblast	Cytotrophoblast
Histone_H3	Histone-H3
Foam_cell	Foam_Cell
Serous_membrane	Serosa
Histone_H4	Histone-H4
Hymen_of_vagina	Hymen
Capsule_of_lens	Lens_Capsule
Granular_component_of_nucleolus	Nucleolonema
Stomatognathic_system	Stomatognathic_System
Osteoclast	Osteoclast
Thorax	Thorax
Thorax	Chest
Basilic_vein	Basilic_Vein
Mucosa_associated_lymphoid_tissue	Mucosa-Associated_Lymphoid_Tissue
Basophil	Leukocyte_Myelocyte_Granulocyte_Basophil_MMHCC
Basophil	Basophil
Liver_parenchyma	Hepatic_Tissue
External_acoustic_tube	External_Acoustic_Meatus
Cortex_of_lymph_node	Lymph_Node_Cortex
Vein	Vein
Frontal_horn_of_lateral_ventricle	Frontal_Horn_of_the_Lateral_Ventricle
Perineurium	Perineurium
Whole_portion_of_vitreous_humor	Vitreous_Humor
Liver	Liver
Mesothelial_cell_of_peritoneum	Peritoneal_Mesothelial_Cell
Medial	Medial
Inferior_vena_cava	Inferior_Vena_Cava
Scrotum	Scrotum
Communicating_cell_junction	Gap_Junction
Odontoblast	Odontoblast
Polychromatophilic_erythroblast	Polychromatophilic_Erythroblast
Olfactory_receptor_cell	Olfactory_Receptor_Neuron
Olfactory_receptor_cell	Olfactory_Cell
Integrin	Integrin
Olfactory_tract	Olfactory_Tract
Rib	Rib
Hair_root	Hair_Root
Mucosa_of_anal_canal	Anal_Mucosa
Trapezoid	Trapezoid
Trapezoid	Trapezoid_Bone
Cavity_of_concha_of_pinna	Cavum_Conchae
Knee_joint	Knee_Joint
Nucleus_accumbens	Accumbens_Nucleus
Pericardium	Pericardium
Cusp_of_cardiac_valve	Cardiac_Valve_Cusp
Labium_minus	Labium_Minus
Superior_thoracic_artery	Superior_Thoracic_Artery
Fifth_lumbar_vertebra	L5_Vertebra
Nucleus_ambiguus	Nucleus_Ambiguus
Mitochondrial_matrix	Mitochondrial_Matrix
Posterior_external_jugular_vein	Posterior_External_Jugular_Vein
Trabecula_of_lymph_node	Lymph_Node_Trabecula
Lutein_cell	Lutein_Cell
Organ_system	Organ_System
Hepatic_stem_cell	Liver_Stem_Cell
Prostate	Prostate_Gland
Common_iliac_vein	Common_Iliac_Vein
Base_of_prostate	Base_of_the_Prostate
Sigmoid_artery	Sigmoid_Artery
Actin_binding_protein	Actin-Binding_Protein
Sarcoplasmic_reticulum	Sarcoplasmic_Reticulum
Muscularis_mucosae	Muscularis_Mucosa
Ganglion_cell_of_retina	Retinal_Ganglion_Cell
Nasolacrimal_duct	Nasolacrimal_Duct
Hyaline_cartilage	Hyaline_Cartilage
Dopamine_receptor	Dopamine_Receptor
Cochlear_hair_cell	Hair_Cell
Androgen	Androgen
Interneuron	Interneuron
Vastus_lateralis	Vastus_Lateralis
Deoxyribonucleic_acid	Deoxyribonucleic_Acid
Epithelium_of_ciliary_body	Ciliary_Epithelium
Neck_of_tooth	Collum_Dentis
Epithelium_of_trachea	Tracheal_Epithelium
Cerebral_hemisphere	Cerebral_Hemisphere
Common_iliac_artery	Common_Iliac_Artery
Superficial	Superficial
Set_of_bones	Bone
Follicular_stimulating_hormone	Follicle_Stimulating_Hormone
Female_urethra	Female_Urethra
Autosome	Autosome
Sinus_venosus	Sinus_Venosus
Posterior_cochlear_nucleus	Dorsal_Cochlear_Nucleus
Maxillary_vein	Internal_Maxillary_Vein
Squamous_cell	Squamous_Cell
Bulbar_conjunctiva	Bulbar_Conjunctiva
Pinna	Auricle
Pinna	External_Ear
Afferent_neuron	Sensory_Neuron
Left_uterine_tube	Left_Fallopian_Tube
External_carotid_artery	External_Carotid_Artery
Cervix_of_uterus	Cervix
Left_main_bronchus	Left_Main_Bronchus
Pancreas	Islet_of_Langerhans
Pancreas	Pancreas
Gustatory_pore	Taste_Pore
Abdominal_aorta	Abdominal_Aorta
Left_hepatic_duct	Left_Hepatic_Duct
Olfactory_trigone	Trigonum_Olfactorium
Atlanto_axial_joint	Atlanto-axial_Joint
Set_of_spinal_nerves	Spinal_Nerve
Myoblast	Myoblast
Superior_surface_of_liver	Superior_Surface_of_the_Liver
Auditory_ossicle	Auditory_Ossicle
Collagen_fibril	Collagen_Fibril
Mastoid_process	Mastoid_Process
Inferior_rectal_artery	Inferior_Rectal_Artery
Neural_crest_cell	Neural_Crest_Cell
Tuber_cinereum	Tuber_Cinereum
Jaw	Jaw
Epithelium_of_choroid_plexus_of_fourth_ventricle	Choroid_Plexus_Epithelium_of_the_Fourth_Ventricle
Cartilage_of_external_ear	External_Ear_Cartilage
Nerve_root	Nerve_Root
Skeletal_system	Skeletal_System
Posterior_spinal_artery	Posterior_Spinal_Artery
Secondary_tooth	Permanent_Tooth
Head	Head
Inferior_suprarenal_artery	Inferior_Suprarenal_Artery
Right_brachiocephalic_vein	Right_Innominate_Vein
Superficial_middle_cerebral_vein	Superficial_Middle_Cerebral_Vein
Fornix_of_vagina	Vaginal_Fornix
Pancreatic_tributary_of_splenic_vein	Pancreatic_Vein
Posterior_wall_of_laryngopharynx	Posterior_Wall_of_the_Hypopharynx
Adrenal_gland	Adrenal_Gland
Anterior_surface_of_lens	Anterior_Surface_of_the_Lens
Cell_to_matrix_adherens_junction	Cell-to-extracellular_Matrix_Junction
P_selectin	P-Selectin
Alveolar_macrophage	Alveolar_Macrophage
Myosin_myofilament	Thick_Filament
Oculomotor_nerve	Oculomotor_Nerve
Posterior_lobe_of_prostate	Posterior_Lobe_of_the_Prostate
Histone_H1	Histone-H1
Sweat_gland_of_eyelid	Gland_of_Moll
Wall_of_body_of_uterus	Wall_of_Body_of_Uterus
Jugular_foramen	Jugular_Foramen
Body_of_nail	Body_of_the_Nail
Endothelium_of_venule	Venule_Endothelium
Scalene_muscle	Scalene_Muscle
Transitional_cell	Transitional_Cell
Follicle_of_ovary	Ovarian_Follicle
Inferior_vestibular_nucleus	Spinal_Vestibular_Nucleus
Cerebellar_cortex	Cerebellar_Cortex
Phrenic_artery	Phrenic_Artery
Anterior_temporal_artery	Anterior_Temporal_Artery
Bulbo_urethral_gland	Cowper_s_Gland
Kinocilium	Kinocilium
Endosome	Endosome
Embryonic_tissue	Embryonic_Tissue
Superior_colliculus	Anterior_Quadrigeminal_Body
Ligament	Ligament
Abdomen	Abdominal_Cavity
Serotonin	Serotonin
Cochlear_nucleus	Cochlear_Nuclei
Cochlear_nucleus	Cochlear_Nucleus
Pelvic_girdle	Pelvic_Girdle
Obturator_artery	Obturator_Artery
Set_of_pancreatic_islets	Islet_of_Langerhans
Greater_omentum	Greater_Omentum
Stroma_of_ovarian_cortex	Stroma_of_the_Ovarian_Cortex
Plakoglobin	Junction_Plakoglobin
Right_renal_artery	Right_Renal_Artery
Elastic_cartilage	Elastic_Cartilage
Subcutaneous_adipose_tissue	Subcutis
Exocrine_system	Exocrine_System
Superior_mesenteric_artery	Superior_Mesenteric_Artery
Left_colic_flexure	Splenic_Flexure
Branch_of_brachial_artery	Brachial_Artery_Branch
Synovial_bursa	Synovial_Bursa
Set_of_renal_pyramids	Renal_Medulla
Hyoid_bone	Hyoid_Bone
Middle_phalanx_of_finger	Middle_Phalanx_of_the_Hand
Nucleolus	Nucleolus
Microtubule_associated_protein	Microtubule_Associated_Protein
Superior_part_of_duodenum	First_Portion_of_the_Duodenum
Set_of_masticatory_muscles	Masseter_Muscle
Urothelium	Urothelium
Messenger_ribonucleic_acid	Messenger_RNA
Amnion	Amnion
Vestibular_sensory_cell	Vestibular_Hair_Cell
Vertebral_arch_joint	Facet_Joint
Stromal_cell	Stromal_Cell
Somatotroph	Somatotroph
Somatotroph	Somatotrope_Cell
Splenic_cord	Splenic_Cord
Chondroblast	Chondroblast
Proteoglycan	Proteoglycan
Postcapillary_venule	Postcapillary_Venule
Phosphatidylinositol	Phosphatidylinositol
Tail_of_pancreas	Tail_of_the_Pancreas
Buccal_surface	Buccal_Surface
Skin_of_elbow	Elbow_Skin
Glans_of_clitoris	Glans_Clitoris
Simple_cuboidal_epithelium	Simple_Cuboidal_Epithelium
Anterior_cranial_fossa	Anterior_Fossa
Notochord	Notochord
Phenylalanine	Phenylalanine
Diaphragm	Diaphragm
Gray_matter_of_neuraxis	Gray_Matter
Brush_cell	Brush_Cell
Collagen	Collagen
Lentiform_nucleus	Lenticular_Nucleus
Lentiform_nucleus	Lentiform_Nucleus
Hair_shaft	Shaft_of_the_Hair
Superior_temporal_gyrus	Superior_Temporal_Gyrus
Epicardium	Epicardium
Rostrum_of_corpus_callosum	Rostrum_of_the_Corpus_Callosum
Segment_of_aorta	Aortic_Segment
Parasympathetic_nervous_system	Parasympathetic_Nervous_System
Insula	Central_Lobe
Insula	Insula
Pyrimidine	Pyrimidine
Serosa_of_uterus	Perimetrium
Special_sense_organ	Organ_of_the_Special_Sense
Left_coronary_artery	Left_Coronary_Artery
Set_of_glands	Anterior_Lobe_of_the_Pituitary_Gland
Right_kidney	Right_Kidney
Coccygeal_vertebra	Coccygeal_Vertebra
Set_of_cervical_vertebrae	Cervical_Vertebra
Erector_spinae_muscle_group	Erector_Spinae
Ulna	Ulna
Talocalcaneal_joint	Subtalar_Joint
L_selectin	Selectin-L
Sensory_neuron	Sensory_Neuron
Stratified_columnar_epithelium	Stratified_Columnar_Epithelium
Root_of_spinal_nerve	Spinal_Nerve_Root
Anterior_mediastinal_lymph_node	Anterior_Mediastinal_Lymph_Node
Intercalated_duct_of_pancreas	Intercalated_Duct_of_the_Pancreas
Uracil	Uracil
Mesodermal_cell	Mesoderm_Cell
Gamma_tubulin	Gamma-Tubulin
Lobe_of_lung	Lung_Lobe
Deltoid	Deltoid
Hilum_of_kidney	Hilar_Area_of_the_Kidney
Internal_iliac_artery	Internal_Iliac_Artery
Sternocleidomastoid	Sternocleidomastoid_Muscle
Clear_chief_cell_of_parathyroid_cell	Parathyroid_Gland_Clear_Cell
Colostrum	Colostrum
Myristic_acid	Myristic_Acid
Neural_cell_adhesion_molecule	CD56_Antigen
Neural_cell_adhesion_molecule	Neural_Cell_Adhesion_Molecule
Penis	Penis
First_lumbar_vertebra	L1_Vertebra
Ligamentum_flavum	Ligamentum_Flavum
White_matter_of_spinal_cord	White_Matter_of_the_Spinal_Cord
Lobe_of_thyroid_gland	Thyroid_Gland_Lobe
Set_of_basal_ganglia	Basal_Ganglia
Medulla_oblongata	Medulla_Oblongata
Lateral_thoracic_artery	Lateral_Thoracic_Artery
Bipolar_neuron	Bipolar_Neuron
Posterior_nucleus_of_thalamus	Posterior_Nucleus_of_the_Thalamus
Salivary_gland	Salivary_Gland
Isthmus_of_hair_follicle	Hair_Follicle_Isthmus
Plantar_metatarsal_artery	Plantar_Metatarsal_Artery
Mucosa_of_larynx	Laryngeal_Mucosa
Transversus_thoracis	Transversus_Thoracis
Clear_cell	Clear_Cell
Sacral_nerve_plexus	Sacral_Plexus
X_chromosome	Chromosome_X
Photoreceptor_layer_of_retina	Layer_of_the_Rods_and_Cones
Submandibular_ganglion	Submandibular_Ganglion
Tibial_nerve	Tibial_Nerve
Lysosome	Lysosome
Thoraco_acromial_artery	Acromial_Thoracic_Artery
Striated_muscle_cell	Striated_Muscle_Tissue_Cell
Subsegmental_bronchus	Subsegmental_Bronchus
Corpus_luteum	Corpus_Luteum
Steroid_hormone	Steroid_Hormone
Steroid_hormone	Therapeutic_Steroid_Hormone
Glucagon_secreting_cell	Alpha_Cell
Conus_medullaris	Conus_Medullaris
Column	Column
Column	Column_Structure
Parafollicular_cell_of_thyroid_gland	Parafollicular_Cell
Internal_ear	Internal_Ear
Glossopharyngeal_nerve	Glossopharyngeal_Nerve
Mitochondrial_ribonucleic_acid	Mitochondrial_RNA
Parathyroid_gland	Parathyroid_Gland
Hilum_of_lymph_node	Lymph_Node_Hilum
Body_of_lateral_ventricle	Body_of_the_Lateral_Ventricle
Body_of_lateral_ventricle	Corpus_Uteri
Facial_nucleus	Facial_Nerve_Nucleus
Tail_of_epididymis	Tail_of_the_Epididymis
Bronchiole	Bronchiole
Secretion_of_seminal_vesicle	Seminal_Vesicle_Secretion
Anterior_tibial_artery	Anterior_Tibial_Artery
Tensor_tympani	Tensor_Tympani
Inner_nuclear_membrane	Nuclear_Inner_Membrane
Autonomic_nervous_system	Autonomic_Nervous_System
Posterior_semicircular_canal	Posterior_Semicircular_Canal
Plasma_transmembrane_protein	Transmembrane_Protein
Root_canal_of_tooth	Canalis_Radicis_Dentis
Left_ventricle	Left_Ventricle
Oxyphil_cell	Oxyphil_Cell
Symphysis	Amphiarthrosis
Outer_membrane_of_mitochondrion	Outer_Mitochondrial_Membrane
Bamacan	Chondroitin_Sulfate_Proteoglycan-6
Minus_end_of_actin_filament	Minus_End_of_the_Actin_Filament
Lateral_frontobasal_artery	Lateral_Orbitofrontal_Artery
Rhamnose	Rhamnose
Thoracic_vertebral_column	Thoracic_Spine
Arteriole	Arteriole
Superior_cistern	Quadrigeminal_Cistern
Superior_cistern	Ambient_Cistern
Triquetral	Triangular_Bone
Subclavian_artery	Subclavian_Artery
Venous_sinus_of_red_pulp_of_spleen	Splenic_Sinus
Palatine_tonsil	Palatine_Tonsil
Nucleotide	Nucleotides
Skin_of_arm	Arm_Skin
Right_subclavian_artery	Right_Subclavian_Artery
Tonsillar_crypt	Tonsillar_Crypt
Longus_capitis	Longus_Capitis
Duct_of_sebaceous_gland	Sebaceous_Gland_Duct
Nervous_system	Nervous_System
Stratified_cuboidal_epithelium	Stratified_Cuboidal_Epithelium
Posterior_wall_of_oropharynx	Posterior_Wall_of_the_Oropharynx
Set_of_ligaments	Ligament
Scapha	Fossa_of_the_Helix
Popliteal_artery	Popliteal_Artery
Deferent_duct	Vas_Deferens
Fascia_cluster	Fascia
Scleral_venous_sinus	Canal_of_Schlemm
Vocal_fold	True_Vocal_Cord
Vocal_fold	Vocal_Cord
Splenic_pulp	Splenic_Pulp
Schwann_cell	Schwann_Cell
Spermatid	Spermatid
Suppressor_effector_T_lymphocyte	Suppressor-Effector_T-Lymphocyte
Vertebral_column	Vertebral_Column
Piriform_fossa	Pyriform_Sinus
Helix	Helix_Structure
Helix	Helix
Primary_hair	Lanugo
Third_ventricle	Third_Ventricle_of_Brain
Pillar_cell_of_cochlea	Pillar_Cell
Respiratory_system	Respiratory_System
Respiratory_system	Lung
Vinculin	Vinculin
N_cadherin	N-Cadherin
Set_of_seminiferous_tubules	Seminiferous_Tubule
Cardia_of_stomach	Cardia
Neurotendinous_ending	Golgi_Tendon_Organ
Uncinate_process_of_pancreas	Uncinate_Pancreas
Muscle_of_anterior_abdominal_wall	Anterior_Abdominal_Wall_Muscle
Quadratus_lumborum	Quadratus_Lumborum
Polysaccharide	Dietary_Polysaccharide
Polysaccharide	Polysaccharide
External_jugular_vein	External_Jugular_Vein
Hemopoietic_stem_cell	Hematopoietic_Stem_Cell
Y_chromosome	Chromosome_Y
Betaglycan	Transforming_Growth_Factor_Beta_Receptor-III
Occipital_lobe	Occipital_Lobe
Anterior_inferior_cerebellar_artery	Anterior_Inferior_Cerebellar_Artery
Radial_artery	Radial_Artery
Cochlear_inner_hair_cell	Inner_Hair_Cell_of_the_Organ_of_the_Corti
Cochlear_inner_hair_cell	Type_I_Hair_Cell
Hepatic_artery	Hepatic_Artery
Epithelioid_cell	Epithelioid_Cell
Lower_lobe_of_lung	Lung_Lower_Lobe
Precentral_sulcus	Precentral_Sulcus
Transitional_epithelium	Transitional_Epithelium
Pectoralis_major	Pectoralis_Major
Lumbar_nerve	Lumbar_Nerve
Sigmoid_colon	Sigmoid_Colon
Luteinizing_hormone	Therapeutic_Luteinizing_Hormone
Luteinizing_hormone	Luteinizing_Hormone
Hypoglossal_nerve_nucleus	Nucleus_of_the_Hypoglossal_Nerve
Hypoglossal_nerve_nucleus	Hypoglossal_Nucleus
Prepuce_of_penis	Male_Prepuce
Prepuce_of_penis	Prepuce
Arachnoid_villus	Arachnoid_Villus
Hard_palate	Hard_Palate
Juxtaglomerular_complex	Juxtaglomerular_Apparatus
Digit	Digit
Digit	Digit_Number
Striated_muscle_tissue	Striated_Muscle_Tissue
Thyroid_cartilage	Thyroid_Cartilage
Primary_ossification_center	Primary_Ossification_Center
Chromosome	Chromosome
Hemidesmosome	Hemidesmosome
Gastric_foveola	Gastric_Pit
High_densitiy_lipoprotein	High_Density_Lipoprotein
Epitympanic_recess	Epitympanic_Recess
Interosseous_muscle_of_hand	Hand_Interosseous_Muscle
Posterior_chamber_of_eyeball	Posterior_Chamber_of_the_Eye
Costodiaphragmatic_recess	Costophrenic_Angle
Inferior_sagittal_sinus	Inferior_Sagittal_Sinus
Pia_mater	Pia_Mater
Amacrine_cell	Amacrine_Cell
Short_bone	Short_Bone
Paranasal_sinus	Paranasal_Sinus_Retired
Paranasal_sinus	Paranasal_Sinus
Tectorial_membrane_of_cochlea	Tectorial_Membrane
Portion_of_blood	Blood
Popliteal_vein	Popliteal_Vein
Posterior_commissure	Posterior_Commissure
Dental_pulp_cell	Tooth_Cell
Central_insular_sulcus	Sulcus_Centralis_Insulae
Sacral_nerve	Sacral_Nerve
E_cadherin	E-Cadherin
Skin_of_neck	Neck_Skin
Interventricular_foramen	Interventricular_Foramen
Superior_gluteal_artery	Gluteal_Artery
Internal_cerebral_vein	Internal_Cerebral_Vein
Testicular_artery	Spermatic_Artery
Renal_column	Cortical_Column
Vestibular_fold	False_Vocal_Cord
Right_testicular_artery	Right_Spermatic_Artery
Spinal_accessory_nerve	Accessory_Nerve
Spinal_accessory_nerve	Spinal_Accessory_Nerve
Sternothyroid	Sternothyroid
Epithelium_of_urethra	Urethra_Epithelium
Paraurethral_gland	Paraurethral_Gland
Paraurethral_gland	Skene_s_Gland
Transport_vesicle	Transport_Vesicle
Linker_DNA	Linker_DNA
Optic_chiasm	Chiasma
Temporal_artery	Temporal_Artery
Anal_gland	Anal_Gland
Pelvis	Pelvis
Seminal_vesicle	Seminal_Vesicle
Synovial_joint	Diarthrosis
Nasal_mucus	Nasal_Mucus
Parotid_duct	Parotid_Duct
Inferior_colliculus	Testis
Inferior_colliculus	Posterior_Quadrigeminal_Body
Keratan_sulfate	Keratan_Sulfate
Alpha_cell	Alpha_Cell
Structural_gene	Molecular_Abnormality
Structural_gene	Structural_Gene
Structural_gene	Gene
Median_nerve	Median_Nerve
Right_hepatic_duct	Right_Hepatic_Duct
Stearic_acid	Stearic_Acid
Osteocyte	Osteocyte
Prostatic_stroma	Prostatic_Stroma
Temporomandibular_joint	Jaw_Joint
Thoracodorsal_artery	Thoracodorsal_Artery
Ankle_joint	Ankle_Joint
Superior_vestibular_nucleus	Superior_Vestibular_Nucleus
Axial_skeleton	Axial_Skeleton
Thyrohyoid	Thyrohyoid
Simple_columnar_epithelium	Simple_Columnar_Epithelium
Superior_sagittal_sinus	Superior_Sagittal_Sinus
Posterior_wall_of_nasopharynx	Posterior_Wall_of_the_Nasopharynx
Fibrous_astrocyte	Fibrous_Astrocyte
Interstitial_cell_of_Cajal	Interstitial_Cell_of_Cajal
Corpus_striatum	Corpus_Striatum
Perianal_skin	Anal_Margin
Semitendinosus	Semitendinosus
Crypt_of_Lieberkuhn	Crypts_of_the_Lieberkuhn
Fifth_sacral_vertebra	S5_Vertebra
Glandular_cell	Glandular_Cell
Left_ovary	Left_Ovary
Vestibular_labyrinth	Vestibular_Labyrinth
Specialized_epithelial_cell	Specialized_Epithelial_Cell
Cochlear_duct_of_membranous_labyrinth	Cochlear_Duct
Small_intestine	Small_Intestine
Small_intestine	Intestine_Small_Intestine_MMHCC
Small_intestine	Small_Intestinal_Fibrosarcoma
Neurohypophysis	Posterior_Lobe_of_the_Pituitary_Gland
Sixth_thoracic_vertebra	T6_Vertebra
Glenohumeral_joint	Shoulder_Joint
Simple_squamous_epithelium	Simple_Squamous_Epithelium
Hematopoietic_cell	Hematopoietic_Cell
Capsule	Capsule
Pylorus	Pylorus
Frontal_nerve	Frontal_Nerve
Segmental_bronchus	Segmental_Bronchus
Sphenoid_bone	Sphenoid_Sinus
Sphenoid_bone	Sphenoid_Bone
Retina	Retina
Retina	Eye_Retina_MMHCC
Inferior_frontal_gyrus	Inferior_Frontal_Gyrus
Inferior_frontal_gyrus	Inferior_Frontal_Convolution
Hormone	Hormone
Teres_minor	Teres_Minor_Muscle
Plantar_part_of_foot	Plantar_Region
Hindgut	Hindgut
Nuclear_inclusion	Nuclear_Inclusion
Heparin	Heparin
Tricuspid_valve	Tricuspid_Valve
Head_of_rib	Rib_Head
Valine	Valine
Muscle_of_larynx	Laryngeal_Muscle
Nasal_muscle	Nasal_Muscle
Sublingual_gland	Sublingual_Salivary_Gland
Intraparietal_sulcus	Intraparietal_Sulcus
Chondroitin_sulfate	Chondroitin_Sulfate
Posterior_cranial_fossa	Posterior_Fossa
Renal_corpuscle	Renal_Corpuscle
Galactose	Galactose
Lesser_trochanter	Lesser_Trochanter
Fetal_heart	Fetal_Heart
Superior_mesenteric_vein	Superior_Mesenteric_Vein
Zygote	Zygote
Pectinate_line	Pectinate_Line
Mucosa_of_esophagus	Esophageal_Mucosa
Mammillary_body	Mamillary_Body
Embryonic_cell	Embryonic_Cell
Right_adrenal_gland	Right_Adrenal_Gland
Multipolar_neuron	Multipolar_Neuron
Sex_chromatin	Barr_Body
Neck_of_femur	Femoral_Neck
Plasma_membrane_of_muscle_cell	Sarcolemma
Skull	Skull
Orbicularis_oculi	Orbicularis_Oculi
Medulla_of_thymus	Thymus_Medulla
Carotid_body	Carotid_Body
Set_of_viscera	Viscera
Spermatic_cord	Spermatic_Cord
Splenius	Splenius
Styloglossus	Styloglossus
Posterior_surface_of_kidney	Kidney_Posterior_Surface
Posterior_surface_of_kidney	Posterior_Surface_of_the_Kidney
Lip	Lip
Lipid	Lipid
Mandible	Mandible
Tryptophan	Tryptophan
Lower_lobe_of_left_lung	Lower_Lobe_of_the_Left_Lung
Purine	Purine
Face	Face
Levator_labii_superioris	Levator_Labii_Superioris
Hepatic_lobule	Hepatic_Lobule
Ganglion	Ganglion
Right_colic_flexure	Hepatic_Flexure
Cricoid_cartilage	Cricoid_Cartilage
Trophoblast_cell	Trophoblastic_Cell
Flatus	Flatus
Plasma_membrane	Plasma_Membrane
Plasma_membrane	Cellular_Membrane
Ectodermal_cell	Ectoderm_Cell
Cell_adhesion_molecule	Cell_Adhesion_Molecule
Greater_curvature_of_stomach	Greater_Curvature
Basal_layer_of_endometrium	Basal_Layer_of_the_Endometrium
Basaloid_cell	Basaloid_Cell
Right_uterine_tube	Right_Fallopian_Tube
Corticotropin_releasing_factor	Corticotropin_Releasing_Hormone
Monosaccharide	Monosaccharide
Dorsolateral_fasciculus_of_medulla	Tract_of_Lissauer
Myoepithelial_cell	Myoepithelial_Cell
Monocyte_chemoattractant_protein_3	Small_Inducible_Cytokine-A7
Common_cardinal_vein	Common_Cardinal_Vein
Facial_artery	Facial_Artery
Articular_cartilage	Articular_Cartilage
Superior_frontal_gyrus	Superior_Frontal_Convolution
Superior_frontal_gyrus	Superior_Frontal_Gyrus
Synoviocyte	Synovial_Cell
Descending_colon	Descending_Colon
Left_suprarenal_vein	Left_Suprarenal_Vein
Somatostatin	Growth_Hormone_Release_Inhibiting_Factor
Somatostatin	Somatostatin
Transverse_fold_of_rectum	Transverse_Rectal_Fold
Celiac_ganglion	Coeliac_Ganglion
Hepatocyte	Hepatocyte
Spermatocyte	Spermatocyte
Hair_follicle	Hair_Follicle
Pluripotent_stem_cell	Pluripotent_Stem_Cell
Lymphatic_capillary	Lymphatic_Capillary
Endosteal_cell	Endosteal_Cell
Endothelium_of_arteriole	Arteriole_Endothelium
Thoracic_duct	Thoracic_Duct
Thalamus	Thalamus
Cardinal_body_part	Body_Region
Hilum_of_spleen	Splenic_Hilum
Rod_cell	Rod
Nasal_bone	Nasal_Bone
Dense_irregular_connective_tissue	Irregular_Dense_Connective_Tissue
Distal_phalanx_of_finger	Distal_Phalanx_of_Hand
Distal_phalanx_of_finger	Distal_Phalanx_of_the_Hand
Substantia_nigra	Substantia_Nigra
Pyloric_gland	Pyloric_Gland
Auditory_cortex	Auditory_Cortex
Internal_iliac_vein	Internal_Iliac_Vein
Dopamine	Dopamine_Base
Dopamine	Dopamine
Cervical_vertebra	Cervical_Vertebra
Low_density_lipoprotein	Low_Density_Lipoprotein
Neural_stem_cell	Neural_Stem_Cell
Pericallosal_artery	Pericallosal_Artery
Upper_lobe_of_right_lung	Upper_Lobe_of_the_Right_Lung
Cartilage_of_bronchus	Bronchus_Cartilage
Globus_pallidus	Globus_Pallidus
Phagosome	Phagosome
Maxillary_artery	Maxillary_Artery
Triangular	Triangle
Corticotropin	Adrenocorticotropic_Hormone
Phagocyte	Phagocytic_Cell
Spiral_organ_of_cochlea	Organ_of_Corti
Spiral_organ_of_cochlea	Spiral_Organ_of_Corti
Right_ureter	Right_Ureter
Parasympathetic_ganglion	Parasympathetic_Ganglion
Thyroid_gland	Thyroid_Gland
Set_of_axillary_lymph_nodes	Axillary_Lymph_Node
Spinal_nerve	Spinal_Nerve
Arch_of_aorta	Aortic_Arch
Corneal_epithelium	Corneal_Epithelium
Olfactory_nerve	Olfactory_Nerve
Olfactory_nerve	Olfactory_Nerve_Neoplasm
Microtubule	Microtubule
Ventral_anterior_nucleus	Vertebral_Artery
Cuneiform_cartilage	Cuneiform_Cartilage
Gingival_margin	Gingival_Margin
Synapse	Synapse
Roof_of_nasopharynx	Superior_Wall_of_the_Nasopharynx
Splenic_vein	Splenic_Vein
Hypoglossal_nerve	Hypoglossal_Nerve
Epigastrium	Epigastric_Region
Diaphragma_sellae	Diaphragma_Sellae
Proline	Proline
Lymphocyte	Lymphocyte
Tongue	Tongue
Cytoskeleton	Cytoskeleton
Mesothelium	Mesothelium
Epithelium_of_esophagus	Esophageal_Epithelium
Muscle	Muscle
Muscle	Muscle_Tissue
Rectus_abdominis	Rectus_Abdominis
Cuboid_bone	Cuboid_Bone
Beta_cell	Beta_Cell
Granular_leukocyte	Granulocyte
Granular_leukocyte	Leukocyte_Myelocyte_Granulocyte_MMHCC
Inferior_parathyroid_gland	Inferior_Parathyroid_Gland
Seminal_fluid	Seminal_Fluid
Tenth_thoracic_vertebra	T10_Vertebra
Myometrium	Myometrium
Smegma	Smegma
Microglial_cell	Microglia
Flat_bone	Flat_Bone
Stratified_squamous_epithelium	Stratified_Squamous_Epithelium
Aorta	Aorta
Erythroid_progenitor_cell	Erythroid_Progenitor_Cell
Medial_geniculate_body	Internal_Geniculate_Body
Leukocyte	Non-Granular_Leukocyte
Leukocyte	Leukocyte
Leukocyte	Leukocyte_WBC_MMHCC
Purkinje_fiber	Purkinje_Fiber
Adenine	Adenine
Erythroblast	Erythroblast
Brown_adipose_tissue	Brown_Adipose_Tissue
Fourth_lumbar_vertebra	L4_Vertebra
Lateral_sulcus	Fissure_of_Sylvius
Intervertebral_disk	Intervertebral_Disc
Heterochromatin	Heterochromatin
Set_of_bronchioles	Bronchiole
Lacrimal_nerve	Lacrimal_Nerve
Glenoid_fossa	Glenoid_Fossa
Vimentin	Vimentin_Protein
Bronchial_vein	Bronchial_Vein
Trigeminal_ganglion	Trigeminal_Ganglion
Fucose	Fucose
Lower_gastrointestinal_tract	Lower_Gastrointestinal_Tract
Parasternal_lymph_node	Internal_Mammary_Lymph_Node
Hepatic_sinusoid	Hepatic_Sinusoid
Peripheral_blood_cell	Peripheral_Blood_Cell
Skin_of_head	Head_Skin
Third_thoracic_vertebra	T3_Vertebra
Transverse_plane	Transverse_Plane
Set_of_phalanges_of_foot	Phalanx_of_the_Foot
Set_of_phalanges_of_foot	Foot_Phalanx
Anterior_cruciate_ligament	Anterior_Cruciate_Ligament
Septum_primum	Septum_Primum
Peripheral_blood_stem_cell	Peripheral_Blood_Stem_Cell
Branch_of_basilar_artery	Basilar_Artery_Branch
Common_palmar_digital_artery	Common_Palmar_Digital_Artery
Pons	Pons_Varolii
Olfactory_bulb	Olfactory_Bulb
Extraglomerular_mesangial_cell	Extraglomerular_Mesangial_Cell
Lymph_node	Lymph_Node
Submental_vein	Submental_Vein
Alanine	Alanine
Trigeminal_nuclear_complex	Trigeminal_Nucleus
Endocrine_gland	Endocrine_Gland
Fibularis_longus	Peroneus_Longus
Glans_penis	Glans_Penis
Saliva	Saliva
Sebum	Sebum
Sebum	Sebum_MMHCC
Neural_crest	Neural_Crest
Intermediate_trophoblast_cell	Intermediate_Trophoblast
Left_lobe_of_thyroid_gland	Left_Thyroid_Gland_Lobe
Lamellar_bone	Mature_Bone
Apex_of_heart	Apex_of_the_Heart
Latissimus_dorsi	Musculus_Latissimus_Dorsi
Lateral_wall_of_nasopharynx	Lateral_Wall_of_the_Nasopharynx
Primordial_germ_cell	Primordial_Germ_Cell
Lumbosacral_nerve_plexus	Lumbosacral_Plexus
Heparan_sulfate	Heparan_Sulfate
Osteoblast	Osteoblast
Oligosaccharide	Oligosaccharide
Flexor_digitorum_profundus	Flexor_Digitorum_Profundus
Third_sacral_vertebra	S3_Vertebra
Inner_membrane_of_mitochondrion	Inner_Mitochondrial_Membrane
Circumflex_branch_of_left_coronary_artery	Circumflex_Branch_of_the_Left_Coronary_Artery
Oxyphil_cell_of_thyroid	Thyroid_Gland_Oxyphil_Cell
Set_of_microglial_cells	Microglia
Muscle_of_face	Facial_Muscle
Antihelix	Antihelix
Retromandibular_vein	Temporo-maxillary_Vein
Cell_cavity	Cell_Space
Costal_cartilage	Costal_Cartilage
Corneoscleral_junction	Corneoscleral_Limbus
Skin_of_knee	Knee_Skin
Inner_cell_mass	Inner_Cell_Mass
Temporal_vein	Temporal_Vein
Conjunctiva	Conjunctiva
Neurilemma	Sheath_of_Schwann
Cardiac_myocyte	Cardiocyte
Tarsal_bone	Tarsal_Bone
Posterior	Posterior
Secretory_granule	Secretory_Granule
Sinus	Sinus
Dentition	Tooth
Dentition	Dentition
Intermediate_filament	Intermediate_Filament
Transitional_epithelial_cell_of_urinary_bladder	Bladder_Transitional_Cell
Transitional_epithelial_cell_of_urinary_bladder	Urothelial_Cell
Anterior_median_fissure_of_spinal_cord	Anterior_Median_Fissure_of_Spinal_Cord
Urachus	Urachus
Neuroglial_cell	Glial_Cell
Cytoplasmic_inclusion	Cytoplasmic_Inclusion
External_nose	External_Nose
Duodenal_gland	Brunner_s_Gland
Body_of_stomach	Body_of_Stomach
Muscle_of_abdomen	Abdominal_Muscle
Midgut	Midgut
Superior_rectal_artery	Superior_Hemorrhoidal_Artery
Eccrine_sweat_gland	Eccrine_Sweat_Gland
Geniculate_ganglion	Geniculate_Ganglion
Vertebral_artery	Vertebral_Artery
Neuron	Neuron
Neuron	Neuron_and_Supporting_Cell_of_the_Nervous_System
Duodenum	Duodenum
Internal_capsule	Internal_Capsule
Interatrial_septum	Interatrial_Septum
White_matter_of_cerebellum	Cerebellum_White_Matter
Skin_of_trunk	Skin_of_the_Trunk
Fatty_acid	Fatty_Acid
Septum_secundum	Septum_Secundum
Epicondyle	Epicondyle
Iris	Uvea
Iris	Iris
Gray_matter_of_spinal_cord	Gray_Matter_of_the_Spinal_Cord
Node_of_Ranvier	Node_of_Ranvier
Metamyelocyte	Metamyelocyte
Labyrinthine_artery	Internal_Auditory_Artery
Utriculosaccular_duct	Utriculosaccular_Duct
Circular_muscle_layer_of_abdominal_part_of_esophagus	Lower_Esophageal_Sphincter
Axilla	Axilla
Metanephros	Metanephros
Vasa_vasorum	Vasa_Vasorum
Laryngopharynx	Hypopharynx
Laryngopharynx	Laryngopharynx
Molar_tooth	Molar_Tooth
Posterior_tibial_artery	Posterior_Tibial_Artery
Posterior_crico_arytenoid_ligament	Posterior_Cricoarytenoid_Ligament
Cricothyroid_joint	Cricothyroid_Joint
Capillary	Blood_Capillary
Capillary	Capillary
Major_salivary_gland	Major_Salivary_Gland
T_helper_cell_type_2	Type_2_Helper_Cell
Anterior_auricular_vein	Anterior_Auricular_Vein
T_helper_cell_type_1	Type_1_Helper_Cell
Systemic_vein	Systemic_Vein
Lymphokine_activated_natural_killer_cell	Lymphokine-Activated_Natural_Killer_Cell
Membranous_labyrinth	Membranous_Labyrinth
Azygos_vein	Azygos_Vein
Aryepiglotticus	Aryepiglottic_Muscle
Ascending_part_of_duodenum	Fourth_Portion_of_the_Duodenum
Caproic_acid	Caproic_Acid
Middle_mediastinum	Middle_Mediastinum
Ischium	Ischium
Left_subcostal_vein	Left_Subcostal_Vein
Semispinalis_capitis	Semispinalis_Capitis
Nucleosome	Nucleosome
Decidua	Decidua
Intestinal_secretion	Intestinal_Secretion
Bone_of_hamate	Hamate_Bone
Posterior_pole_of_lens	Posterior_Pole_of_the_Lens
Set_of_paranasal_sinuses	Paranasal_Sinus
Skin_of_foot	Foot_Skin
Integument	Skin
Lamina_propria_of_bronchus	Bronchus_Lamina_Propria
Anterior_meningeal_branch_of_anterior_ethmoidal_artery	Anterior_Meningeal_Artery
Ilium	Ilium
Arteriovenous_anastomosis	Arteriovenous_Shunt
Cervical_vertebral_column	Cervical_Spine
Fusiform_cell	Fusiform_Cell
Tonsillar_ring	Waldeyers_Tonsillar_Ring
Foramen_magnum	Foramen_Magnum
Vestibulocochlear_nerve	Vestibulocochlear_Nerve
Glandular_cell_of_stomach	Gastric_Glandular_Cell
Levator_ani	Levator_Ani
Premolar_tooth	Bicuspid_Tooth
Posterior_longitudinal_ligament	Posterior_Longitudinal_Ligament
Laryngeal_cartilage	Laryngeal_Cartilage
Testicular_vein	Spermatic_Vein
Temporalis	Temporal_Muscle
Minus_end_of_microtubule	Minus_End_of_the_Microtubule
Brachiocephalic_vein	Innominate_Vein
Myelin	Myelin
Myelin	Myelin_Sheath
Cell_junction	Cell_Junction
Right_testis	Right_Testis
Synovial_membrane	Synovial_Membrane
Sweat_gland	Sweat_Gland
Eotaxin	CCL11_Gene
Eotaxin	Small_Inducible_Cytokine-A11
Radius	Radius
Radius	Radius_Bone
Left_inguinal_part_of_abdomen	Left_Inguinal_Region
Lateral_aperture_of_fourth_ventricle	Foramen_of_Luschka
Seventh_cervical_vertebra	C7_Vertebra
Type_II_alveolar_epithelial_cell	Alveolar_Cell_Type_II
Toe	Toe
P_cadherin	P-Cadherin
Inferior_mesenteric_artery	Inferior_Mesenteric_Artery
Ganglion_cell	Ganglion_Cell
Lobule	Lobule
Smooth_muscle_tissue	Smooth_Muscle_Tissue
Lactiferous_terminal_ductal_lobular_unit	Terminal_Ductal_Lobular_Unit
Syndecan	Syndecans
Membrane_of_mitochondrion	Mitochondrial_Membrane
Perineum	Perineum
Endothelium	Endothelium
Fifth_cervical_vertebra	C5_Vertebra
Longitudinal_fissure	Longitudinal_Fissure
Saccule_of_membranous_labyrinth	Saccule
Epineurium	Epineurium
Anterior	Anterior
Subthalamic_nucleus	Subthalamic_Nucleus
Mononuclear_phagocyte_system	Reticuloendothelial_System
Inflow_part_of_right_atrium	Sinus_Venarum
Obturator_muscle	Obturator_Muscle
Leg	Leg
Sulcus_limitans	Sulcus_Limitans
Tentorium_cerebelli	Tentorium_Cerebelli
Internal_thoracic_artery	Internal_Mammary_Artery
Point	Point
Estrogen	Estrogen
Epithelium_of_nasopharynx	Nasopharynx_Epithelium
Gastrophrenic_ligament	Gastrophrenic_Ligament
Peritoneal_macrophage	Peritoneal_Macrophage
Cymba_conchae_of_pinna	Cymba_Conchae
Oral_cavity	Buccal_Cavity
Oral_cavity	Oral_Cavity
Skeletal_muscle_cell	Skeletal_Fiber
Skeletal_muscle_cell	Rhabdomyocyte
Skeletal_muscle_cell	Muscle_Fibers_Slow-Twitch
Skeletal_muscle_cell	Skeletal_Muscle_Cell
Skeletal_muscle_cell	Muscle_Fibers_Fast-Twitch
Mechanoreceptor	Mechanoreceptor
Buccal_salivary_gland	Buccal_Salivary_Gland
Epithelium_of_vagina	Vaginal_Epithelium
Semicircular_duct	Semicircular_Duct
Left_common_iliac_artery	Left_Common_Iliac_Artery
Dorsal_part_of_foot	Dorsal_Region_of_Foot
Occipital_bone	Occipital_Bone
Basal_cell	Basal_Cell
Endocardium	Endocardium
Endocardium	Endocardial_Myxoma
Axillary_vein	Axillary_Vein
Cartilage_tissue	Cartilagenous_Tissue
Intermediate	Muscle_Fibers_Slow-Twitch
Intermediate	Intermediate
Composite	Composite
Anterior_commissure	Anterior_Commissure
Mental_artery	Mental_Artery
Stem_cell	Hematopoietic_Stem_Cell
Stem_cell	Stem_Cell
Prostatic_utricle	Prostatic_Utricle
Pulmonary_trunk_sinus	Sinus_of_Valsava
Left_cerebral_hemisphere	Left_Cerebral_Hemisphere
Nasal_septum	Nasal_Septum
Interleukin_9	Interleukin-9
Interleukin_8	Interleukin-8
Interleukin_8	Therapeutic_Interleukin-8
Ovarian_medulla	Ovarian_Medulla
Interleukin_5	Interleukin-5
Interleukin_4	Interleukin-4
Interleukin_7	Interleukin-7
Interleukin_6	Interleukin-6
Posterior_inferior_cerebellar_artery	Posterior_Inferior_Cerebellar_Artery
Anterior_limiting_lamina_of_cornea	Bowman_s_Membrane
Acromioclavicular_joint	Acromioclavicular_Joint
Tubercle_of_rib	Rib_Tubercle
Collagen_fiber	Collagen_Fiber
Collagen_fiber	Collagen_Fibril
Wall_of_organelle	Intracellular_Membrane
Isoleucine	Isoleucine
Cricothyroid_muscle	Cricothyroid_Muscle
Posterior_parietal_artery	Posterior_Parietal_Artery
Myelin_sheath	Myelin_Sheath
Decidual_cell	Decidual_Cell
Bony_labyrinth	Osseous_Labyrinth
Osteon	Haversian_System
Cecum	Cecum
Rectovesical_pouch	Recto-Vesical_Pouch
Middle_frontal_gyrus	Middle_Frontal_Gyrus
Femoral_artery	Femoral_Artery
Nail	Nail_Plate
Nail	Nail
Uterine_tube	Fallopian_Tube
Prostatic_epithelium	Prostatic_Epithelium
T_lymphoblast	T-Lymphoblast
Secondary_nodular_lymphoid_tissue	Germinal_Center
Apical_foramen_of_root_of_tooth	Foramen_Apicis_Dentis
Fibronectin	Fibronectin
Optic_tract	Optic_Tract
Axillary_tail_of_breast	Axillary_Tail_of_the_Breast
Thyrohyoid_ligament	Thyrohyoid_Ligament
Mitochondrial_deoxyribonucleic_acid	Mitochondrial_DNA
Cutaneous_vein	Cutaneous_Vein
Syncytial_trophoblast	Syncytiotrophoblast
Retroperitoneal_space	Retroperitoneum
Retroperitoneal_space	Retroperitoneal_Space
Ileocolic_vein	Ileocolic_Vein
Tragus	Tragus
Vertical	Vertical
Vitreous_chamber_of_eyeball	Vitreous_Chamber
Celiac_trunk	Coeliac_Artery
Labium_majus	Labium_Majus
Subarachnoid_cistern	Subarachnoid_Cistern
Integumentary_system	Integumentary_System
Esophageal_artery	Esophageal_Artery
Set_of_splenic_trabeculae	Splenic_Trabecula
Upper_limb	Upper_Extremity
Utricle_of_membranous_labyrinth	Utricle
Utricle_of_membranous_labyrinth	Prostatic_Utricle
Amphiarthrosis	Amphiarthrosis
Enteroendocrine_cell	Enteroendocrine_Cell
Enteroendocrine_cell	Enterochromaffin_Cell
Nonmembranous_cytoplasmic_organelle	Nonmembranous_Cytoplasmic_Organelle
Coracobrachialis	Coracobrachialis
Bulb_of_hair_follicle	Hair_Bulb
Bone	Bone
Centriole	Centriole
Thoracic_vertebra	Thoracic_Vertebra
Vitelline_vein	Vitelline_Vein
Interleukin_1	Interleukin-1
Promonocyte	Promonocyte
Superior_suprarenal_artery	Superior_Suprarenal_Artery
Interleukin_3	Interleukin-3
B_lymphoblast	B-Lymphoblast
Interleukin_2	Interleukin-2
Nuclear_lamina	Nuclear_Lamina
Orbital_part_of_inferior_frontal_gyrus	Orbital_Part_of_the_Inferior_Frontal_Gyrus
Orbital_part_of_inferior_frontal_gyrus	Inferior_Frontal_Gyrus
Body_of_corpus_callosum	Body_of_the_Corpus_Callosum
Body_of_corpus_callosum	Corpus_Callosum
Body_of_corpus_callosum	Corpus_Uteri
Ovarian_cortex	Ovarian_Cortex
Posterior_cerebral_artery	Posterior_Cerebral_Artery
Occipital_horn_of_lateral_ventricle	Occipital_Horn_of_the_Lateral_Ventricle
Cell_body	Perikaryon
Apical	Apical
Thigh	Thigh
Atrioventricular_bundle	Atrioventricular_Bundle
Stroma	Stroma
Stroma	Stroma_Connective_Tissue
Sternum	Sternum
Auditory_system	Auditory_System
Gastrocolic_ligament	Gastrocolic_Ligament
Talus	Talus
Breast	Breast
Lacrimal_sac	Lacrimal_Sac
Ovarian_vein	Ovarian_Vein
Gingival_epithelium	Gingival_Epithelium
Labial_salivary_gland	Labial_Salivary_Gland
Mesentery	Mesentery
Ear	Ear
Ear	External_Ear
Set_of_vertebrae	Vertebra
Right_surface_of_liver	Lateral_Surface_of_the_Liver
Promyelocyte	Promyelocyte
Cytoplasmic_organelle	Cytoplasmic_Organelle
Phospholipid	Phospholipid
Capsule_of_adrenal_gland	Adrenal_Gland_Capsule
Tonsil	Tonsil
Adipose_tissue	Adipose_Tissue
Anterior_parietal_artery	Anterior_Parietal_Artery
Pigmented_layer_of_retina	Retinal_Pigment_Epithelium
Thymic_vein	Thymic_Vein
Transfer_ribonucleic_acid	Transfer_RNA
Pancreatic_duct	Pancreatic_Duct
Respiratory_bronchiole	Respiratory_Bronchiole
Columnar_cell	Columnar_Cell
Cis_Golgi_network	Cis-Golgi_Network
Epithelium_of_choroid_plexus_of_lateral_ventricle	Choroid_Plexus_Epithelium_of_the_Lateral_Ventricle
Central_retinal_artery	Retinal_Artery
Femoral_nerve	Femoral_Nerve
Epinephrine	Therapeutic_Epinephrine
Epinephrine	Epinephrine
Glycoprotein	Glycoprotein
Vagina	Vagina
Set_of_pharyngeal_muscles	Pharyngeal_Muscle
Epithelial_cell	Epithelial_Cell
Leptomeninx	Leptomeninges
Ampullary_crest_of_semicircular_duct	Ampullary_Crest
Inguinal_lymph_node	Inguinal_Lymph_Node
Surface_of_bone	Bone_Surface
Hepatopancreatic_ampulla	Ampulla_of_Vater
Guanyl_nucleotide_binding_protein	G_Protein_Gene
Guanyl_nucleotide_binding_protein	G_Protein
Skin_of_abdomen	Abdominal_Skin
Cistern_of_lamina_terminalis	Lamina_Terminalis_Cistern
Pseudostratified_ciliated_columnar_epithelium	Pseudostratified_Columnar_Ciliated_Epithelium
Intercellular_matrix	Integrin
Intercellular_matrix	Extracellular_Matrix
Nucleus_of_brain	Brain_Nucleus
Endocrine_system	Endocrine_System
Leucine	Leucine
Fascicle	Fascicle
First_thoracic_vertebra	T1_Vertebra
Theca_lutein_cell	Theca_Cell
Theca_lutein_cell	Theca_Lutein_Cell
Columnar_cell_of_endocervix	Endocervical_Columnar_Cell
Granulosa_lutein_cell	Granulosa_Lutein_Cell
Spleen	Spleen
Macula_densa	Macula_Densa
Cervical_part_of_esophagus	Cervical_Esophagus
Actin_myofilament	Thin_Filament
Sympathetic_ganglion	Sympathetic_Ganglion
Basilar_artery	Basilar_Artery
Distal_convoluted_tubule	Distal_Convoluted_Tubule
Deep_femoral_artery	Deep_Femoral_Artery
Superior_temporal_sulcus	Superior_Temporal_Sulcus
Temporal_fossa	Temporal_Fossa
Epithelium_of_bronchus	Bronchial_Epithelium
Renal_fascia	Renal_Capsule
Cell_component	Cell_Part
Red_pulp_of_spleen	Splenic_Red_Pulp
Fossa_of_antihelix	Fossa_of_the_Antihelix
Taste_bud_cell	Taste_Bud_Cell
Set_of_pelvic_lymph_nodes	Pelvic_Lymph_Node
Cortex	Cortex
Middle	Middle
Body_of_uterus	Corpus_Uteri
Posterior_cruciate_ligament	Posterior_Cruciate_Ligament
External_naris	Nostril
Renal_vein	Renal_Vein
Intrapulmonary_bronchus	Intrapulmonary_Bronchus
Dopaminergic_neuron	Dopaminergic_Cell
Preganglionic_neuron	Visceral_Efferent_Neuron
Testis	Testis
Thoracic_aorta	Thoracic_Aorta
Intron	Intron
Pyloric_orifice	Pyloric_Orifice
Connective_tissue_cell	Connective_and_Soft_Tissue_Cell
Cochlear_outer_hair_cell	Outer_Hair_Cell_of_the_Organ_of_the_Corti
Cochlear_outer_hair_cell	Type_II_Hair_Cell
Yolk_sac	Yolk_Sac
Irregular_bone	Irregular_Bone
Crypt_of_Lieberkuhn_of_large_intestine	Large_Intestinal_Crypt_of_the_Lieberkuhn
Ciliary_muscle	Ciliary_Muscle
Bronchial_artery	Bronchial_Artery
Chromophobe_cell	Chromophobe_Cell
Anterior_surface_of_prostate	Anterior_Surface_of_the_Prostate
Internal_anal_sphincter	Internal_Anal_Sphincter
Delta_cell	Delta_Cell
Facial_vein	Facial_Vein
Choroidal_fissure	Choroidal_Fissure
Umbilical_cord	Umbilical_Cord
Secretion	Cellular_Secretion
Anterior_spinal_artery	Anterior_Spinal_Artery
Sixth_cervical_vertebra	C6_Vertebra
Inner_phalangeal_cell_of_cochlea	Inner_Supporting_Cell
Dentate_gyrus_of_hippocampal_formation	Dentate_Gyrus
Left_atrium	Left_Atrium
Buccinator	Buccinator
External_pyramidal_layer_of_neocortex	External_Pyramidal_Cell_Layer
Outside	External
Duct	Duct
Hypogastrium	Hypogastric_Region
Xylose	Xylose
Uterus	Uterus
Intestine	Intestine
Endodermal_cell	Endoderm_Cell
Tertiary_follicle_of_ovary	Graafian_Follicle
Macula_of_saccule_of_membranous_labyrinth	Macula_of_Saccule
Right	Right
Peripheral_nerve	Peripheral_Nerve
Orbit	Orbit
Superior_hypophysial_artery	Superior_Hypophyseal_Artery
Long_insular_gyrus	Gyrus_Longus_Insulae
Subiculum	Subiculum
Frontal_bone	Frontal_Bone
Forearm	Forearm
Euchromatin	Euchromatin
Inferior_hypogastric_nerve_plexus	Inferior_Hypogastric_Nerve_Plexus
Perineal_artery	Perineal_Artery
Lacrimal_artery	Lacrimal_Artery
Macrophage	Macrophage
Sartorius	Sartorius_Muscle
Myenteric_nerve_plexus	Myenteric_Nerve_Plexus
Early_endosome	Early_Endosome
Early_endosome	Endocytotic_Vesicle
Corniculate_cartilage	Corniculate_Cartilage
Adrenocorticotropin	Adrenocorticotropic_Hormone
Flatulence	Flatulence
Serosa	Serosa
Left_hypochondrium	Left_Hypochondriac_Region
Cone_cell	Cone
Posterior_auricular_vein	Posterior_Auricular_Vein
Epithelial_cell_of_thymus	Thymic_Epithelial_Cell
Spermatogonium	Spermatogonium
Body_of_penis	Body_of_the_Penis
Greater_vestibular_gland	Bartholin_s_Gland
Somatic_cell	Somatic_Cell
Nuclear_membrane	Nuclear_Membrane
Myeloblast	Myeloblast
Lipoblast	Lipoblast
Cell_body_of_neuron	Perikaryon
Infundibulum_of_hair_follicle	Hair_Follicle_Infundibulum
T_helper_lymphocyte	CD4_Plus_T-Lymphocyte
Endocrine_cell	Endocrine_Cell_and_Neuroendocrine_Cell
B_lymphocyte	B-Lymphocyte
Oxytocin	OXT_Gene
Oxytocin	Oxytocin
Nail_of_toe	Toe_Nail
Psoas_minor	Psoas_Minor
Histone	Histone
Tendon	Tendon
Palatine_bone	Palatine_Bone
Genu_of_corpus_callosum	Genu_of_the_Corpus_Callosum
Genu_of_corpus_callosum	Corpus_Callosum
Hepatic_macrophage	Kupffer_Cell
Brachial_nerve_plexus	Brachial_Plexus
Body_of_vertebra	Vertebral_Body
Head_of_humerus	Head_of_the_Humerus
Palatine_salivary_gland	Palatine_Salivary_Gland
Enamel	Enamel
Trapezium	Trapezial_Bone
Plasmablast	Plasmablast
Vagus_nerve	Vagus_Nerve
Exon	Exon
Endocervix	Endocervix
Goblet_cell	Goblet_Cell
Cervical_nerve	Cervical_Nerve
Monoblast	Monoblast
Abducens_nucleus	Abducens_Nucleus
Chorion	Chorion
Large_intestine	Colon
Large_intestine	Large_Intestine
Transverse_facial_artery	Transverse_Facial_Artery
Pyloric_antrum	Antrum_Pylori
Anterior_perforated_substance	Posterior_Olfactory_Lobule
Superficial_temporal_vein	Superficial_Temporal_Vein
Capsule_of_ovary	Ovarian_Capsule
Cavity_of_body_of_uterus	Endometrial_Cavity
Collicular_artery	Quadrigeminal_Artery
Anal_sinus	Anal_Sinus
Uncus	Uncus
Muscle_of_neck	Neck_Muscle
Nasal_cartilage	Nasal_Cartilage
Medial_tarsal_artery	Medial_Tarsal_Artery
Throat	Throat
Central	Center
Urethral_gland	Urethra_Gland_MMHCC
Urethral_gland	Urethral_Gland
Superior_parathyroid_gland	Superior_Parathyroid_Gland
Lower_limb	Lower_Extremity
Mesangium	Mesangium
Distal	Distal
Thyrotropin	Thyroid_Stimulating_Hormone
Pulmonary_valve	Pulmonary_Valve
Main_submandibular_duct	Submandibular_Duct
Cerumen	Cerumen
Cytosine	Cytosine
Middle_temporal_gyrus	Middle_Temporal_Gyrus
Nasopharynx	Nasopharynx
Nitrergic_neuron	Nitrergic_Neuron
Laminin	Laminin
Lobar_bronchus	Lobar_Bronchus
Costochondral_joint	Costochondral_Joint
Fundus_of_uterus	Fundus_Uteri
Chest_wall	Chest_Wall
Interleukin	Interleukin
Anterior_choroidal_artery	Anterior_Choroidal_Artery
Type_I_alveolar_epithelial_cell	Alveolar_Cell_Type_I
Type_I_alveolar_epithelial_cell	Squamous_Alveolar_Lining_Cell
Hepatic_perisinusoidal_space	Perisinusoidal_Space
Hippocampal_sulcus	Hippocampal_Sulcus
Hippocampal_sulcus	Hippocampal_Fissure
Enteric_ganglion	Enteric_Ganglion
Axillary_artery	Axillary_Artery
Esophagus	Esophagus
Pronator_teres	Pronator_Teres
Descending_aorta	Descending_Aorta
Middle_cardiac_vein	Middle_Cardiac_Vein
Reticulocyte	Polychromatophilic_Erythrocyte
Subthalamus	Ventral_Thalamus
Oncocyte	Oxyphil_Cell
Insulin	Therapeutic_Insulin
Insulin	Regular_Insulin
Insulin	Insulin
Mucosa_of_upper_lip	Mucosa_of_the_Upper_Lip
Occluding_cell_junction	Tight_Junction
Lesser_curvature_of_stomach	Lesser_Curvature
Claustrum	Claustrum
Right_subcostal_vein	Right_Subcostal_Vein
Angular_artery	Angular_Artery
Inferior	Inferior
Inferior	Inferior_Sagittal_Sinus
Ulnar_nerve	Ulnar_Nerve
Lumbar_vertebra	Lumbar_Vertebra
Epiglottic_cartilage	Epiglottic_Cartilage
Extensor_digitorum_longus	Extensor_Digitorum_Longus
Lobe_of_liver	Liver_Lobe
Glial_filament	Glial_Fibrillary_Acidic_Protein
Totipotent_stem_cell	Totipotent_Stem_Cell
Main_bronchus	Main_Bronchus
Neck_of_gallbladder	Gallbladder_Neck
Cytoskeletal_filament	Filament
Epithelium_of_respiratory_bronchiole	Respiratory_Bronchiole_Epithelium
Ganglionic_layer_of_retina	Ganglion_Cell_Layer
Perimysium	Perimysium
Falx_cerebelli	Falx_Cerebelli
Lacrimal_bone	Lacrimal_Bone
Middle_lobe_of_lung	Right_Lung
Middle_lobe_of_lung	Middle_Lobe_of_the_Right_Lung
Neural_cell	Neuron
Neural_cell	Neuron_and_Supporting_Cell_of_the_Nervous_System
Common_hepatic_duct	Common_Hepatic_Duct
Common_hepatic_duct	Hepatic_Duct
Longissimus_cervicis	Longissimus_Cervicis
Supraspinatus	Supraspinatus
Set_of_aggregated_lymphoid_nodules_of_small_intestine	Peyer_s_Patch
Cochlear_nerve	Cochlear_Nerve
Right_renal_vein	Right_Renal_Vein
Second_lumbar_vertebra	L2_Vertebra
Subclavian_vein	Subclavian_Vein
Terminal_sulcus	Sulcus_Terminalis
Merkel_cell	Merkel_Cell
Anterior_olfactory_nucleus	Anterior_Olfactory_Nucleus
Tibia	Tibia
Tarsal_gland	Meibomian_Gland
Thyrotroph	Thyrotrope_Cell
Thyrotroph	Thyrotroph_Cell
Proprioceptor	Proprioceptor
Choroid_plexus_of_lateral_ventricle	Choroid_Plexus_of_the_Lateral_Ventricle
Endocrine_pancreas	Islet_of_Langerhans
Endocrine_pancreas	Endocrine_Pancreas
Floor_of_mouth	Floor_of_the_Mouth
Skin_of_face	Skin_of_the_Face
Iliocostalis_thoracis	Iliocostal_Muscle
Valve_of_inferior_vena_cava	Eustachian_Valve
Supramarginal_gyrus	Supramarginal_Gyrus
Left_adrenal_gland	Left_Adrenal_Gland
Bone_of_scaphoid	Scaphoid_Bone
Gluteus_maximus	Gluteus_Maximus
Xiphoid_process	Xiphoid_Process
Parahippocampal_gyrus	Parahippocampal_Gyrus
Trigeminal_nerve	Trigeminal_Nerve
Pacinian_corpuscle	Vater-Pacini_Corpuscle
Cystic_duct	Cystic_Duct
Infraclavicular_lymph_node	Infraclavicular_Lymph_Node
Orbital_cavity	Orbit
Autonomic_ganglion	Autonomic_Ganglion
Gonadotropin	Gonadotropin
Omohyoid	Omohyoid
Posterior_wall_of_pharynx	Posterior_Wall_of_the_Pharynx
Epiglottis	Epiglottis
Inguinal_part_of_abdomen	Inguinal_Region
Interleukin_15	Interleukin-15
Bone_of_capitate	Capitate_Bone
Interleukin_13	Interleukin-13
Renshaw_cell	Renshaw_Cell
Cerebral_vein	Cerebral_Vein
Interleukin_12	Therapeutic_Interleukin-12
Interleukin_12	Interleukin-12B
Interleukin_12	Interleukin-12A
Interleukin_12	Interleukin-12
Interleukin_10	Interleukin-10
Vascular_layer_of_eyeball	Uvea
Epithelium_of_paranasal_sinus	Paranasal_Sinus_Epithelium
Middle_colic_artery	Middle_Colic_Artery
Olfactory_epithelium	Olfactory_Epithelium
Skin_of_ankle	Ankle_Skin
Triceps_surae	Triceps_Surae
Interleukin_18	Interleukin-18
Interleukin_17	Therapeutic_Interleukin-17
Interleukin_17	Interleukin-17
Intestinal_mucosa	Intestinal_Mucosa
Transverse_colon	Transverse_Colon
Arytenoid_cartilage	Arytenoid_Cartilage
Tympanic_membrane	Tympanic_Membrane
Set_of_thoracic_vertebrae	Thoracic_Vertebra
Stapedius	Stapedius_Muscle
Cochlear_labyrinth	Cochlear_Labyrinth
Trans_Golgi_network	Trans-Golgi_Network
Pericardial_cavity	Pericardial_Cavity
Hair	Hair
Posterior_choroidal_artery	Posterior_Choroidal_Artery
Basal_cell_layer_of_epidermis	Rete_Malpighii
Male_urethra	Male_Urethra
Scaffold_protein	Scaffolding_Protein
Paneth_cell	Paneth_Cell
Intercostal_nerve	Intercostal_Nerve
Renal_pelvis	Renal_Pelvis
Lateral	Lateral_Ventricle
Lateral	Lateral
Aqueous_humor_of_eyeball	Aqueous_Humor
Cave_of_septum_pellucidum	Fifth_Ventricle
Cerebellar_vein	Cerebellar_Vein
Vertebral_vein	Vertebral_Vein
Brachiocephalic_artery	Innominate_Artery
Nail_of_finger	Fingernail
Anterior_chamber_of_eyeball	Anterior_Chamber_of_the_Eye
Peroxisome	Peroxisome
Microvillus	Microvillus
Lateral_vestibular_nucleus	Lateral_Vestibular_Nucleus
Longissimus_thoracis	Longissimus_Thoracis
Sciatic_nerve	Sciatic_Nerve
Ovarian_artery	Ovarian_Artery
Precentral_gyrus	Precentral_Gyrus
Multilaminar_epithelium	Stratified_Epithelium
Medial_vestibular_nucleus	Medial_Vestibular_Nucleus
Caudate_nucleus	Caudate_Nucleus
Mast_cell	Mast_Cell
APUD_cell	APUD_Cell
Lateral_wall_of_oropharynx	Lateral_Wall_of_the_Oropharynx
External_anal_sphincter	External_Anal_Sphincter
Medial_circumflex_femoral_artery	Medial_Circumflex_Artery
Head_of_femur	Head_of_the_Femur
Type_B_cell_of_pancreatic_islet	Beta_Cell
Palmitic_acid	Palmitic_Acid
Adhesive_belt	Zonula_Adherens
Hip_joint	Hip_Joint
Trunk	Trunk
Triangular_part_of_inferior_frontal_gyrus	Triangular_Part_of_the_Inferior_Frontal_Gyrus
Natural_killer_cell	Natural_Killer_Cell_Retired
Natural_killer_cell	Natural_Killer_Cell
Chemokine	Alpha_Chemokine
Chemokine	Beta_Chemokine
Chemokine	Chemokine
Parietal_lobe	Parietal_Lobe_of_the_Brain
Olfactory_epithelial_cell	Olfactory_Epithelial_Cell
Phalanx_of_finger	Hand_Phalanx
Phalanx_of_finger	Phalanx_of_the_Hand
Myocardium	Heart_Muscle
Myocardium	Myocardium
Right_lobe_of_liver	Right_Lobe_of_the_Liver
Zygomaticus_minor	Zygomaticus_Minor
Cardiac_atrium	Cardiac_Atrium
Articular_disc	Meniscus
Capitate	Capitate_Bone
Fourth_ventricle	Fourth_Ventricle_of_the_Brain
Waist	Waist
Sternohyoid	Sternohyoid
Immunoglobulin	Antibody
Immunoglobulin	Immunoglobulin
Medial_meniscus	Meniscus_Medialis
Masseteric_artery	Masseteric_Artery
Lung	Lung
Lung	Lung_Lower_Lobe
Lung	Lung_Upper_Lobe
Lung	Lung_Surfactant
Internal	Internal
Luteotropin_releasing_factor	Gonadotrophin_Releasing_Hormone
Lacrimal_gland	Lacrimal_Gland
Deep	Deep
Vestibular_ganglion	Vestibular_Ganglion
Hyo_epiglottic_ligament	Hyoepiglottic_Ligament
Perineal_muscle	Perineal_Muscle
Cerebrospinal_fluid	Cerebrospinal_Fluid
Lingual_tonsil	Lingual_Tonsil
Pancreatic_centro_acinar_cell	Pancreatic_Centroacinar_Cell
Apocrine_sweat_gland	Apocrine_Sweat_Gland
Inferior_epigastric_vein	Deep_Epigastric_Vein
Root_of_lumbar_spinal_nerve	Lumbar_Spinal_Nerve_Root
Oxyphil_cell_of_parathyroid_gland	Parathyroid_Gland_Oxyphil_Cell
Lunate	Lunate_Bone
Arginine	Arginine_Base
Arginine	Arginine
Superior_mediastinum	Superior_Mediastinum
Cysteine	Cysteine
Body_of_pancreas	Body_of_the_Pancreas
Umbilical_vein	Umbilical_Vein
Infraspinatus_muscle	Infraspinatus
Interlobular_bile_duct	Interlobular_Bile_Duct
Median_artery	Median_Artery
Obturator_vein	Obturator_Vein
Lymphokine	Lymphokine
Myeloid_stem_cell	Myeloid_Cell
Gastric_gland	Fundic_Gland
Semen	Semen
Oogonium	Primary_Oocyte
Set_of_gastric_folds	Gastric_Rugae
Nasal_concha	Nasal_Turbinate
Chemical_synapse	Chemical_Synapse
Cuboidal_cell	Cuboidal_Cell
Somatotropin	Therapeutic_Growth_Hormone
Somatotropin	Growth_Hormone
Round_ligament_of_uterus	Round_Ligament_of_the_Uterus
Back_of_abdomen	Lumbar_Region
Gingiva	Gum
Gingiva	Gingiva
Portion_of_muscle_tissue	Muscle_Tissue
Small_cardiac_vein	Small_Cardiac_Vein
Thyroglossal_duct	Thyroglossal_Duct
Mitotic_chromosome	Mitotic_Chromosome
Cuneate_nucleus	Cuneate_Nucleus
Right_common_carotid_artery	Right_Common_Carotid_Artery
Epithelial_cell_of_renal_tubule	Renal_Cell
Dorsum_of_tongue	Dorsum_of_the_Tongue
Olecranon	Olecranon
Axosomatic_synapse	Axosomatic_Synapse
Otolith	Otolith
Coronary_sinus	Coronary_Sinus
Endomysium	Endomysium
Dendrite	Dendrite
Lymphatic_vessel	Lymphatic_Vessel
Superficial_lymphatic_vessel	Superficial_Lymphatic_Vessel
Type_IV_taste_bud_cell	Taste_Bud_Basal_Cell
Zona_pellucida	Zona_Pellucida
Myelocyte	Myelocyte
Right_main_bronchus	Right_Main_Bronchus
Lesser_omentum	Lesser_Omentum
Inferior_epigastric_artery	Inferior_Epigastric_Artery
Oxyntic_cell	Parietal_Cell
Cisterna_chyli	Chyle_Cistern
Nuclear_pore	Nuclear_Pore
Temporal_lobe	Temporal_Lobe
Lysine	Lysine
Peripheral	Peripheral
Glycosaminoglycan	Glycosaminoglycan
Photoreceptor	Photoreceptor_Cell
Intermediate_filament_protein	Intermediate_Filament_Protein
Nerve	Nerve
Portal_triad	Portal_Triad
Artery	Artery
Cutaneous_muscle	Cutaneous_Muscle
Melanin	Melanin
Glial_fibrillar_acidic_protein	GFAP_Gene
Glial_fibrillar_acidic_protein	Glial_Fibrillary_Acidic_Protein
Pharynx	Pharynx
Eye	Eye
Branch_of_left_coronary_artery	Left_Coronary_Artery_Branch
Lateral_meniscus	Meniscus_Lateralis
Horizontal	Horizontal
Femoral_vein	Femoral_Vein
Anterior_cerebral_artery	Anterior_Cerebral_Artery
Urethra	Urethra
Principal_sensory_nucleus_of_trigeminal_nerve	Principal_Sensory_Nucleus_of_the_Trigeminal_Nerve
Smooth_endoplasmic_reticulum	Smooth_Endoplasmic_Reticulum
Lymphoid_tissue	Lymphoid_Tissue
Lymphoid_tissue	Mucosa-Associated_Lymphoid_Tissue
Cytokine	Cytokine
Branch_of_posterior_tibial_artery	Posterior_Tibial_Artery_Branch
Glycine	Glycine
Distal_part_of_ileum	Terminal_Ileum
Stromal_cell_of_endometrium	Endometrial_Stromal_Cell
Sacrum	Sacral_Bone
Sacrum	Sacrum
Desmosome	Desmosome
