Anterior_longitudinal_ligament	Anterior_Longitudinal_Ligament	anterior longitudinal ligament
Immune_system	Immune_System	immune system
Troponin_I	Troponin-I	troponin i
Troponin_T	Troponin_T	troponin t
Calcium_binding_protein	Calcium_Binding_Protein	calcium binding protein
Set_of_joints	Joint	joints
Sacrococcygeal_joint	Sacrococcygeal_Joint	sacrococcygeal joint
Pectoralis_minor	Pectoralis_Minor	pectoralis minor
Sertoli_cell	Sertoli_Cell	sertoli cell
Left_ureter	Left_Ureter	left ureter
Minor_salivary_gland	Minor_Salivary_Gland	minor salivary gland
Interventricular_septum	Interventricular_Septum	interventricular septum
Mitochondrial_crista	Mitochondrial_Crista	mitochondrial crista
Seventh_thoracic_vertebra	T7_Vertebra	thoracic vii vertebra
Periosteal_cell	Periosteal_Cell	periosteal cell
Dendritic_cell	Dendritic_Cell	dendritic cell
External_capsule	External_Capsule	external capsule
Aggregated_lymphoid_follicle_of_small_intestine	Peyer_s_Patch	peyer s patch
Tarsal_plate_of_eyelid	Tarsal_Plate	tarsal plate
Pericardiacophrenic_vein	Pericardiacophrenic_Vein	pericardiacophrenic vein
Axoaxonic_synapse	Axoaxonic_Synapse	axoaxonic synapse
Radial_nerve	Radial_Nerve	radial nerve
Parietal_pleura	Parietal_Pleura	parietal pleura
Metatarsal_bone	Metatarsal_Bone	metatarsal bone
Mediastinal_lymph_node	Mediastinal_Lymph_Node	mediastinal lymph node
Microtubule_triplet	Microtubule_Triplet	microtubule triplet
Chromaffin_cell	Chromaffin_Cell	chromaffin cell
Anal_column	Anal_Column	anal column
Lacrimal_canaliculus	Lacrimal_Canaliculus	lacrimal canaliculus
Supra_orbital_vein	Supra-orbital_Vein	supra orbital vein
Levator_palpebrae_superioris	Levator_Palpebrae_Superioris	levator palpebrae superioris
Nerve_plexus	Nerve_Plexus	nerve plexus
Ependymal_cell	Ependymal_Cell	ependymal cell
Postcentral_sulcus	Postcentral_Sulcus	postcentral sulcus
Cerebral_aqueduct	Cerebral_Aqueduct	cerebral aqueduct
Endometrial_stroma	Endometrial_Stroma	endometrial stroma
Adherens_junction	Anchoring_Junction	adhesive junction
Appendix	Vermiform_Appendix	vermiform appendix
Mesothelial_cell_of_pleura	Pleural_Mesothelial_Cell	pleural mesothelial cell
Elastin_fiber	Elastin_Fiber	elastin fiber
Fovea_centralis	Fovea_Centralis	fovea centralis
Macula_lutea	Macula_Lutea	macula lutea
Chief_cell	Chief_Cell	chief cell
Reticular_cell	Reticular_Cell	reticular cell
Third_cervical_vertebra	C3_Vertebra	cervical iii vertebra
Elbow_joint	Elbow_Joint	elbow joint
Muscle_of_tongue	Tongue_Muscle	tongue muscle
Late_endosome	Late_Endosome	late endosome
Gamma_motor_neuron	Gamma_Motor_Neuron	gamma motor neuron
Physical_state	Physical_State	physical state
Left_kidney	Left_Kidney	left kidney
Portal_lobule	Portal_Lobule	portal lobule
Fascia_lata	Fascia_Lata	fascia lata
Extrahepatic_bile_duct	Extrahepatic_Bile_Duct	extrahepatic bile duct
Membranous_cytoplasmic_organelle	Membranous_Cytoplasmic_Organelle	membranous cytoplasmic organelle
Special_sense_organ_system	Special_Sense_Organ_System	special sense organ system
Keratinized_squamous_cell_of_esophagus	Esophageal_Squamous_Cell	esophageal squamous cell
Posterior_temporal_artery	Posterior_Temporal_Artery	posterior temporal artery
Nuclear_matrix	Nuclear_Matrix	nuclear matrix
Common_iliac_lymph_node	Iliac_Lymph_Node	iliac lymph node
Efferent_ductule	Efferent_Ductule	efferent ductule
Ductus_arteriosus	Ductus_Arteriosus	ductus arteriosus
Posterior_meningeal_artery	Posterior_Meningeal_Artery	posterior meningeal artery
Fourth_sacral_vertebra	S4_Vertebra	sacral iv vertebra
Beta_adrenergic_receptor	Beta_Adrenergic_Receptor	beta adrenergic receptor
Flexor_carpi_ulnaris	Flexor_Carpi_Ulnaris	flexor carpi ulnaris
Orbital_sulcus	Orbital_Sulcus	orbital sulcus
Sex_chromosome	Sex_Chromosome	sex chromosome
Papillary_muscle	Papillary_Muscle	papillary muscle
Bowman_s_space	Urinary_Space	urinary space
Superior_vena_cava	Superior_Vena_Cava	superior vena cava
Brachial_vein	Brachial_Vein	brachial vein
Right_ovary	Right_Ovary	right ovary
Chondrocyte	Cartilage_Cell	cartilage cell
Band_cell	Band_Cell	band cell
Pulmonary_lobule	Pulmonary_Lobule	pulmonary lobule
Basophil_cell	Basophilic_Cell	basophilic cell
Tuberculum_sellae	Tuberculum_Sellae	tuberculum sellae
Dorsal_metatarsal_vein	Dorsal_Metatarsal_Vein	dorsal metatarsal vein
Renal_interstitial_cell	Renal_Interstitial_Cell	renal interstitial cell
Lower_eyelid	Lower_Eyelid	lower eyelid
Descending_limb_of_loop_of_Henle	Descending_Limb_of_the_Henle_s_Loop	descending limb of henle s loop
Myelinated_nerve_fiber	Myelinated_Nerve_Fiber	myelinated nerve fiber
Primary_oocyte	Primary_Oocyte	primary oocyte
Tunica_intima	Tunica_Intima	tunica intima
Right_common_iliac_artery	Right_Common_Iliac_Artery	right common iliac artery
Left_renal_artery	Left_Renal_Artery	left renal artery
Myo_inositol	Inositol	myo inositol
Upper_gastrointestinal_tract	Upper_Gastrointestinal_Tract	upper gastrointestinal tract
Submandibular_duct	Submandibular_Duct	submandibular duct
Coronary_artery	Coronary_Artery	coronary artery
Deep_vein	Deep_Vein	deep vein
Superior_vesical_artery	Superior_Vesical_Artery	superior vesical artery
Semicircular_canal	Semicircular_Canal	semicircular canal
Layer_of_retina	Retina_Layer	retina layer
Squamous_cell_of_ectocervix	Ectocervical_Squamous_Cell	ectocervical squamous cell
Compact_bone	Cortical_Bone	cortical bone
Blood_vessel	Blood_Vessel	blood vessel
Ciliary_process	Ciliary_Process	ciliary process
Prostatic_urethra	Prostatic_Portion_of_the_Male_Urethra	prostatic urethra
Peripheral_nervous_system	Peripheral_Nervous_System	peripheral nervous system
Collateral_sulcus	Collateral_Fissure	collateral fissure
Intestinal_epithelium	Intestinal_Epithelium	intestinal epithelium
Atlanto_occipital_joint	Atlanto-occipital_Joint	atlanto occipital joint
Decidua_basalis	Decidua_Basalis	decidua basalis
Buccal_mucosa	Buccal_Mucosa	buccal mucosa
Thyroidea_ima_artery__variant_	Thyroid_Ima_Artery	thyroid ima artery
Renal_pyramid	Renal_Pyramid	renal pyramid
Trabecula_of_spleen	Splenic_Trabecula	splenic trabecula
Haversian_canal	Haversian_Canal	haversian canal
Heparan_sulfate_proteoglycan	Heparan_Sulfate_Proteoglycan	hspg
Muscle_of_palate	Palatal_Muscle	palatal muscle
Hepatic_vein	Hepatic_Vein	hepatic vein
Synaptic_cleft	Synaptic_Cleft	synaptic cleft
Canine_tooth	Canine_Tooth	canine tooth
Temporal_bone	Temporal_Bone	temporal bone
Fourth_cervical_vertebra	C4_Vertebra	cervical iv vertebra
Free_ribosome	Free_Ribosome	free ribosome
Deep_middle_cerebral_vein	Deep_Middle_Cerebral_Vein	deep middle cerebral vein
Glandular_cell_of_esophagus	Esophageal_Glandular_Cell	esophageal glandular cell
Bulbus_cordis	Bulbus_Cordis	bulbus cordis
Amniotic_cavity	Amniotic_Cavity	amniotic cavity
Chief_cell_of_parathyroid_gland	Parathyroid_Gland_Chief_Cell	parathyroid gland chief cell
Set_of_neuroglial_cells	Glial_Cell	glia
Neuroendocrine_cell	Neuroendocrine_Cell	neuroendocrine cell
Skeletal_muscle_tissue	Skeletal_Muscle_Tissue	skeletal muscle tissue
Bile_canaliculus	Bile_Canaliculus	bile canaliculus
Rectus_femoris	Rectus_Femoris	rectus femoris
External_intercostal_muscle	External_Intercostal_Muscle	external intercostal muscle
Biceps_femoris	Biceps_Femoris	biceps femoris
Cytoskeletal_protein	Cytoskeletal_Protein	cytoskeletal protein
Carpometacarpal_joint	Carpometacarpal_Joint	carpometacarpal joint
Extraembryonic_celom	Extraembryonic_Coelom	extraembryonic coelom
Giant_cell	Giant_Cell	giant cell
Unencapsulated_nerve_ending	Free_Nerve_Ending	free nerve ending
Acinar_cell	Acinar_Cell	acinar cell
Processus_cochleariformis	Processus_Cochleariformis	processus cochleariformis
Islet_cell	Islet_Cell	islet cell
Lamina_propria	Lamina_Propria	lamina propria
Intercalated_cell_of_collecting_duct_of_renal_tubule	Intercalated_Cell	intercalated cell
Ductus_venosus	Ductus_Venosus	ductus venosus
Cell_morphology	Cellular_Morphology	cell morphology
Interleukin_12B	Interleukin-12B	interleukin iiib
Esophageal_gland	Esophageal_Gland	esophageal gland
Goblet_cell_of_small_intestine	Small_Intestinal_Goblet_Cell	small intestinal goblet cell
Space_of_Mall	Space_of_Mall	space of mall
Superficial_cervical_artery	Superficial_Cervical_Artery	superficial cervical artery
Esophagogastric_junction	Gastroesophageal_Junction	gastroesophageal junction
Zygomatic_arch	Zygomatic_Arch	zygoma
Corpus_callosum	Corpus_Callosum	corpus callosum
Triangular_ligament	Triangular_Ligament	triangular ligament
Deep_lymphatic_vessel	Deep_Lymphatic_Vessel	deep lymphatic vessel
Sella_turcica	Sella_Turcica	sella turcica
Cephalic_vein	Cephalic_Vein	cephalic vein
Interphase_chromosome	Interphase_Chromosome	interphase chromosome
Unipolar_neuron	Unipolar_Neuron	unipolar neuron
Parietal_bone	Parietal_Bone	parietal bone
Ileal_diverticulum	Meckel_Diverticulum	meckel s diverticulum
Nuclear_lamin	Nuclear_Lamin	nuclear lamin
Secretory_cell	Secretory_Cell	secretory cell
Pyloric_sphincter	Pyloric_Sphincter	pyloric sphincter
Buccal_artery	Buccal_Artery	buccal artery
Splenial_artery	Splenial_Artery	splenial artery
Suppressor_inducer_T_lymphocyte	Suppressor-Inducer_T-Lymphocyte	suppressor inducer t lymphocyte
Cardiac_vein	Cardiac_Vein	cardiac vein
Ribonucleic_Acid	Ribonucleic_Acid	rna
Suprarenal_vein	Suprarenal_Vein	suprarenal vein
Popliteal_lymph_node	Popliteal_Lymph_Node	popliteal lymph node
Common_carotid_artery	Carotid_Artery	carotid artery
Cauda_equina	Cauda_Equina	cauda equina
Male_breast	Male_Breast	male breast
Superior_anastomotic_vein	Superior_Anastomotic_Vein_of_the_Trolard	superior anastomotic vein of trolard
Cystic_vein	Cystic_Vein	cystic vein
Corneal_endothelium	Corneal_Endothelium	corneal endothelium
Lingual_salivary_gland	Lingual_Salivary_Gland	lingual salivary gland
Substantia_gelatinosa	Substantia_Gelatinosa	substantia gelatinosa
Sphenoparietal_sinus	Sphenoparietal_Sinus	sphenoparietal sinus
Eleventh_thoracic_vertebra	T11_Vertebra	thoracic ii vertebra
Primary_tooth	Temporary_Tooth	deciduous tooth
Ninth_thoracic_vertebra	T9_Vertebra	t9 vertebra
Muscle_cell	Muscle_Cell	myocyte
Left_renal_vein	Left_Renal_Vein	left renal vein
Pseudostratified_columnar_epithelium	Pseudostratified_Columnar_Epithelium	pseudostratified columnar epithelium
Superficial_vein	Superficial_Vein	superficial vein
Eotaxin_3	CCL26_Gene	cclumbar iivi
Lateral_thyrohyoid_ligament	Lateral_Thyrohyoid_Ligament	lateral thyrohyoid ligament
CC_chemokine	Beta_Chemokine	cc chemokine
Bone_marrow_stem_cell	Bone_Marrow_Stem_Cell	bone marrow stem cell
Interstitial_cell	Interstitial_Cell	interstitial cell
Surface_ectoderm	Surface_Ectoderm	surface ectoderm
Electrical_synapse	Electrical_Synapse	electrical synapse
Sacral_vertebra	Sacral_Vertebra	sacral vertebra
Internal_thoracic_vein	Internal_Thoracic_Vein	internal thoracic vein
Glucuronic_acid	Glucuronic_Acid	glucuronic acid
Trachea	Trachea	windpipe
Extensor_carpi_radialis_brevis	Extensor_Carpi_Radialis_Brevis	extensor carpi radialis brevis
Brachial_artery	Brachial_Artery	brachial artery
Totipotent_neuroepithelial_stem_cell	Totipotent_Neuroepithelial_Stem_Cell	totipotent neuroepithelial stem cell
Renal_tubule	Renal_Tubule	renal tubule
Anterior_communicating_artery	Anterior_Communicating_Artery	anterior communicating artery
Argentaffin_cell	Argentaffin_Cell	argentaffin cell
Cortex_of_thymus	Thymus_Cortex	thymus cortex
Right_hypochondrium	Right_Hypochondriac_Region	right hypochondriac region
Nissl_body	Nissl_Body	nissl body
Skin_of_leg	Leg_Skin	leg skin
Portal_venous_system	Portal_Venous_System	portal venous system
Gallbladder	Gallbladder	gall bladder
Anterior_tibial_vein	Anterior_Tibial_Vein	anterior tibial vein
Masseteric_vein	Masseteric_Vein	masseteric vein
Longissimus_capitis	Longissimus_Capitis	longissimus capitis
Surface_of_cell	Cell_Surface	cell surface
Alpha_adrenergic_receptor	Alpha_Adrenergic_Receptor	alpha adrenergic receptor
Elastic_fiber	Elastic_Fiber	elastic fiber
Right_lung	Right_Lung	right lung
Gluteus_medius	Gluteus_Medius	gluteus medius
Lymphatic_system	Lymphatic_System	lymphatic system
Histone_H2A	Histone-H2A	histone hiia
Actin_filament	Actin_Filament	actin filament
Submandibular_gland	Submandibular_Gland	submandibular gland
Langerhans_cell	Langerhans_Cell	langerhans cell
Set_of_duodenal_glands	Brunner_s_Gland	brunner s glands
Ascending_colon	Ascending_Colon	ascending colon
Alveolar_sac	Alveolar_Sac	alveolar sac
Intercarpal_joint	Carpal_Joint	carpal joint
Upper_jaw	Upper_Jaw	upper jaw
Skin_of_wrist	Wrist_Skin	wrist skin
Crypt_of_Lieberkuhn_of_small_intestine	Small_Intestinal_Crypt_of_Lieberkuhn	small intestinal crypt of lieberkuhn
Extensor_carpi_radialis_longus	Extensor_Carpi_Radialis_Longus	extensor carpi radialis longus
Axodendritic_synapse	Axodendritic_Synapse	axodendritic synapse
Lumbar_artery	Lumbar_Artery	lumbar artery
Keratin_filament	Keratin_Filament	keratin filament
Hepatogastric_ligament	Hepatogastric_Ligament	hepatogastric ligament
Embryonic_stem_cell	Embryonic_Stem_Cell	embryonic stem cell
Endothelium_of_capillary	Capillary_Endothelium	capillary endothelium
Decidua_capsularis	Decidua_Capsularis	decidua capsularis
Tendinous_cuff	Rotator_Cuff	rotator cuff
Episcleral_layer_of_eyeball	Episclera	episcleral layer
Flexor_carpi_radialis	Flexor_Carpi_Radialis	flexor carpi radialis
Cerebral_white_matter	Cerebral_White_Matter	cerebral white matter
Striated_border	Striated_Border	striated border
Occipital_artery	Occipital_Artery	occipital artery
Zygomaticus_major	Zygomaticus_Major	zygomaticus major
Left_lung	Left_Lung	left lung
Fenestrated_capillary	Fenestrated_Capillary	fenestrated capillary
Lower_jaw	Lower_Jaw	lower jaw
Muscle_spindle	Muscle_Spindle	muscle spindle
Type_I_cell_of_carotid_body	Glomus_Cell	glomus cell
Ciliated_columnar_cell_of_tracheobronchial_tree	Ciliated_Bronchial_Epithelial_Cell	ciliated bronchial epithelial cell
Peptide_hormone	Peptide_Hormone	peptide hormone
Ileocecal_valve	Ileocecal_Valve	ileocecal valve
Cricothyroid_ligament	Cricothyroid_Ligament	cricothyroid ligament
Foramen_secundum	Foramen_Secundum	foramen secundum
Crus_of_helical_part_of_auricular_cartilage	Crus_Helicis	crus helicis
Ileal_vein	Ileal_Vein	ileal vein
Lateral_ventricle	Lateral_Ventricle	lateral ventricle
Amygdala	Amygdaloid_Body	amygdaloid nucleus
Nephrogenic_cord	Nephrogenic_Cord	nephrogenic cord
Set_of_bronchi	Bronchus	bronchi
Posterior_tibial_vein	Posterior_Tibial_Vein	posterior tibial vein
Medial_forebrain_bundle	Medial_Forebrain_Bundle	medial forebrain bundle
Juxtaglomerular_cell	Juxtaglomerular_Cell	juxtaglomerular cell
Cerebellopontine_angle	Cerebellopontine_Angle	cerebellopontine angle
Thyroid_follicular_cell	Thyroid_Gland_Follicular_Cell	thyroid gland follicular cell
Bone_tissue	Bone_Tissue	bone tissue
Bronchial_tree	Bronchial_Tree	bronchial tree
Middle_ear	Middle_Ear	middle ear
Ascending_limb_of_loop_of_Henle	Ascending_Limb_of_the_Henle_s_Loop	ascending limb of henle s loop
Axillary_lymph_node	Axillary_Lymph_Node	axillary lymph node
Thyro_epiglottic_ligament	Thyroepiglottic_Ligament	thyroepiglottic ligament
Deep_temporal_vein	Deep_Temporal_Vein	deep temporal vein
Histone_H3	Histone-H3	histone hiii
Foam_cell	Foam_Cell	foam cell
Histone_H4	Histone-H4	histone hiv
Capsule_of_lens	Lens_Capsule	lens capsule
Stomatognathic_system	Stomatognathic_System	stomatognathic system
Inferior_vena_cava	Inferior_Vena_Cava	inferior vena cava
Polychromatophilic_erythroblast	Polychromatophilic_Erythroblast	polychromatophilic erythroblast
Olfactory_receptor_cell	Olfactory_Cell	olfactory receptor cell
Hair_root	Hair_Root	hair root
Labium_minus	Labium_Minus	labium minus
Superior_thoracic_artery	Superior_Thoracic_Artery	superior thoracic artery
Fifth_lumbar_vertebra	L5_Vertebra	lumbar v vertebra
Nucleus_ambiguus	Nucleus_Ambiguus	nucleus ambiguus
Posterior_external_jugular_vein	Posterior_External_Jugular_Vein	posterior external jugular vein
Sigmoid_artery	Sigmoid_Artery	sigmoid artery
Actin_binding_protein	Actin-Binding_Protein	actin binding protein
Sarcoplasmic_reticulum	Sarcoplasmic_Reticulum	sarcoplasmic reticulum
Hyaline_cartilage	Hyaline_Cartilage	hyaline cartilage
Dopamine_receptor	Dopamine_Receptor	dopamine receptor
Vastus_lateralis	Vastus_Lateralis	vastus lateralis
Deoxyribonucleic_acid	Deoxyribonucleic_Acid	dna
Epithelium_of_trachea	Tracheal_Epithelium	tracheal epithelium
Common_iliac_artery	Common_Iliac_Artery	common iliac artery
Sinus_venosus	Sinus_Venosus	sinus venosus
Squamous_cell	Squamous_Cell	squamous cell
Bulbar_conjunctiva	Bulbar_Conjunctiva	bulbar conjunctiva
Left_uterine_tube	Left_Fallopian_Tube	left fallopian tube
Left_hepatic_duct	Left_Hepatic_Duct	left hepatic duct
Olfactory_trigone	Trigonum_Olfactorium	trigonum olfactorium
Atlanto_axial_joint	Atlanto-axial_Joint	atlanto axial joint
Auditory_ossicle	Auditory_Ossicle	auditory ossicle
Collagen_fibril	Collagen_Fibril	collagen fibril
Neural_crest_cell	Neural_Crest_Cell	neural crest cell
Tuber_cinereum	Tuber_Cinereum	tuber cinereum
Cartilage_of_external_ear	External_Ear_Cartilage	external ear cartilage
Nerve_root	Nerve_Root	nerve root
Inferior_suprarenal_artery	Inferior_Suprarenal_Artery	inferior suprarenal artery
Pancreatic_tributary_of_splenic_vein	Pancreatic_Vein	pancreatic vein
Cell_to_matrix_adherens_junction	Cell-to-extracellular_Matrix_Junction	cell to extracellular matrix junction
Alveolar_macrophage	Alveolar_Macrophage	alveolar macrophage
Histone_H1	Histone-H1	histone hi
Endothelium_of_venule	Venule_Endothelium	venule endothelium
Transitional_cell	Transitional_Cell	transitional cell
Phrenic_artery	Phrenic_Artery	phrenic artery
Embryonic_tissue	Embryonic_Tissue	embryonic tissue
Pelvic_girdle	Pelvic_Girdle	pelvic girdle
Set_of_pancreatic_islets	Islet_of_Langerhans	islets of langerhans
Right_renal_artery	Right_Renal_Artery	right renal artery
Elastic_cartilage	Elastic_Cartilage	elastic cartilage
Exocrine_system	Exocrine_System	exocrine system
Synovial_bursa	Synovial_Bursa	synovial bursa
Hyoid_bone	Hyoid_Bone	hyoid bone
Messenger_ribonucleic_acid	Messenger_RNA	messenger rna
Splenic_cord	Splenic_Cord	splenic cord
Postcapillary_venule	Postcapillary_Venule	postcapillary venule
Brush_cell	Brush_Cell	brush cell
Lentiform_nucleus	Lentiform_Nucleus	lentiform nucleus
Superior_temporal_gyrus	Superior_Temporal_Gyrus	superior temporal gyrus
Parasympathetic_nervous_system	Parasympathetic_Nervous_System	parasympathetic nervous system
Special_sense_organ	Organ_of_the_Special_Sense	special sense organ
Right_kidney	Right_Kidney	right kidney
Erector_spinae_muscle_group	Erector_Spinae	erector spinae
Talocalcaneal_joint	Subtalar_Joint	subtalar joint
Mesodermal_cell	Mesoderm_Cell	mesodermal cell
Gamma_tubulin	Gamma-Tubulin	gamma tubulin
Ligamentum_flavum	Ligamentum_Flavum	ligamentum flavum
Lobe_of_thyroid_gland	Thyroid_Gland_Lobe	thyroid gland lobe
Lateral_thoracic_artery	Lateral_Thoracic_Artery	lateral thoracic artery
Sacral_nerve_plexus	Sacral_Plexus	sacral plexus
Submandibular_ganglion	Submandibular_Ganglion	submandibular ganglion
Striated_muscle_cell	Striated_Muscle_Tissue_Cell	striated muscle cell
Subsegmental_bronchus	Subsegmental_Bronchus	subsegmental bronchus
Corpus_luteum	Corpus_Luteum	corpus luteum
Steroid_hormone	Steroid_Hormone	steroid hormone
Secretion_of_seminal_vesicle	Seminal_Vesicle_Secretion	seminal vesicle secretion
Anterior_tibial_artery	Anterior_Tibial_Artery	anterior tibial artery
Tensor_tympani	Tensor_Tympani	tensor tympani
Root_canal_of_tooth	Canalis_Radicis_Dentis	canalis radicis dentis
Lateral_frontobasal_artery	Lateral_Orbitofrontal_Artery	lateral orbitofrontal artery
Triquetral	Triangular_Bone	triangular bone
Palatine_tonsil	Palatine_Tonsil	palatine tonsil
Skin_of_arm	Arm_Skin	arm skin
Right_subclavian_artery	Right_Subclavian_Artery	right subclavian artery
Tonsillar_crypt	Tonsillar_Crypt	tonsillar crypt
Longus_capitis	Longus_Capitis	longus capitis
Set_of_ligaments	Ligament	ligaments
Deferent_duct	Vas_Deferens	vas deferens
Vocal_fold	Vocal_Cord	vocal cord
Schwann_cell	Schwann_Cell	schwann cell
Vertebral_column	Vertebral_Column	spine
Piriform_fossa	Pyriform_Sinus	piriform sinus
Third_ventricle	Third_Ventricle_of_Brain	third ventricle
External_jugular_vein	External_Jugular_Vein	external jugular vein
Y_chromosome	Chromosome_Y	y chromosome
Anterior_inferior_cerebellar_artery	Anterior_Inferior_Cerebellar_Artery	anterior inferior cerebellar artery
Hepatic_artery	Hepatic_Artery	hepatic artery
Epithelioid_cell	Epithelioid_Cell	epithelioid cell
Precentral_sulcus	Precentral_Sulcus	precentral sulcus
Transitional_epithelium	Transitional_Epithelium	transitional epithelium
Pectoralis_major	Pectoralis_Major	musculus pectoralis major
Sigmoid_colon	Sigmoid_Colon	sigmoid colon
Prepuce_of_penis	Prepuce	preputium penis
Arachnoid_villus	Arachnoid_Villus	arachnoid villus
Hard_palate	Hard_Palate	hard palate
Juxtaglomerular_complex	Juxtaglomerular_Apparatus	juxtaglomerular apparatus
Striated_muscle_tissue	Striated_Muscle_Tissue	striated muscle tissue
Thyroid_cartilage	Thyroid_Cartilage	thyroid cartilage
Primary_ossification_center	Primary_Ossification_Center	primary ossification center
Gastric_foveola	Gastric_Pit	gastric foveola
Short_bone	Short_Bone	short bone
Paranasal_sinus	Paranasal_Sinus_Retired	paranasal sinus
Sacral_nerve	Sacral_Nerve	sacral nerve
Skin_of_neck	Neck_Skin	neck skin
Interventricular_foramen	Interventricular_Foramen	interventricular foramen
Internal_cerebral_vein	Internal_Cerebral_Vein	internal cerebral vein
Transport_vesicle	Transport_Vesicle	transport vesicle
Linker_DNA	Linker_DNA	linker dna
Temporal_artery	Temporal_Artery	temporal artery
Anal_gland	Anal_Gland	anal gland
Nasal_mucus	Nasal_Mucus	nasal mucus
Keratan_sulfate	Keratan_Sulfate	keratan sulfate
Structural_gene	Structural_Gene	structural gene
Right_hepatic_duct	Right_Hepatic_Duct	right hepatic duct
Prostatic_stroma	Prostatic_Stroma	prostatic stroma
Ankle_joint	Ankle_Joint	ankle joint
Interstitial_cell_of_Cajal	Interstitial_Cell_of_Cajal	interstitial cell of cajal
Perianal_skin	Anal_Margin	perianal skin
Crypt_of_Lieberkuhn	Crypts_of_the_Lieberkuhn	crypt of lieberkuhn
Glandular_cell	Glandular_Cell	glandular cell
Left_ovary	Left_Ovary	left ovary
Small_intestine	Intestine_Small_Intestine_MMHCC	small intestine
Simple_squamous_epithelium	Simple_Squamous_Epithelium	simple squamous epithelium
Segmental_bronchus	Segmental_Bronchus	tertiary bronchus
Teres_minor	Teres_Minor_Muscle	teres minor muscle
Plantar_part_of_foot	Plantar_Region	plantar region
Nuclear_inclusion	Nuclear_Inclusion	nuclear inclusion
Head_of_rib	Rib_Head	rib head
Chondroitin_sulfate	Chondroitin_Sulfate	chondroitin sulfate
Posterior_cranial_fossa	Posterior_Fossa	posterior cranial fossa
Renal_corpuscle	Renal_Corpuscle	renal corpuscle
Fetal_heart	Fetal_Heart	fetal heart
Superior_mesenteric_vein	Superior_Mesenteric_Vein	superior mesenteric vein
Multipolar_neuron	Multipolar_Neuron	multipolar neuron
Neck_of_femur	Femoral_Neck	neck of femur
Trophoblast_cell	Trophoblastic_Cell	trophoblastic cell
Cell_adhesion_molecule	Cell_Adhesion_Molecule	cell adhesion molecule
Basaloid_cell	Basaloid_Cell	basaloid cell
Monocyte_chemoattractant_protein_3	Small_Inducible_Cytokine-A7	monocyte chemoattractant protein iii
Common_cardinal_vein	Common_Cardinal_Vein	common cardinal vein
Left_suprarenal_vein	Left_Suprarenal_Vein	left suprarenal vein
Transverse_fold_of_rectum	Transverse_Rectal_Fold	transverse rectal fold
Celiac_ganglion	Coeliac_Ganglion	celiac ganglion
Pluripotent_stem_cell	Pluripotent_Stem_Cell	pluripotent stem cell
Lymphatic_capillary	Lymphatic_Capillary	lymphatic capillary
Endosteal_cell	Endosteal_Cell	endosteal cell
Thoracic_duct	Thoracic_Duct	thoracic duct
Nasal_bone	Nasal_Bone	nasal bone
Pyloric_gland	Pyloric_Gland	pyloric gland
Auditory_cortex	Auditory_Cortex	auditory cortex
Neural_stem_cell	Neural_Stem_Cell	neural stem cell
Pericallosal_artery	Pericallosal_Artery	pericallosal artery
Maxillary_artery	Maxillary_Artery	maxillary artery
Right_ureter	Right_Ureter	right ureter
Parasympathetic_ganglion	Parasympathetic_Ganglion	parasympathetic ganglion
Rectus_abdominis	Rectus_Abdominis	rectus abdominis
Cuboid_bone	Cuboid_Bone	cuboid bone
Beta_cell	Beta_Cell	beta cell
Seminal_fluid	Seminal_Fluid	seminal fluid
Flat_bone	Flat_Bone	flat bone
Stratified_squamous_epithelium	Stratified_Squamous_Epithelium	stratified squamous epithelium
Intervertebral_disk	Intervertebral_Disc	intervertebral disc
Set_of_bronchioles	Bronchiole	bronchioles
Bronchial_vein	Bronchial_Vein	bronchial vein
Lower_gastrointestinal_tract	Lower_Gastrointestinal_Tract	lower gastrointestinal tract
Hepatic_sinusoid	Hepatic_Sinusoid	hepatic sinusoid
Peripheral_blood_cell	Peripheral_Blood_Cell	peripheral blood cell
Third_thoracic_vertebra	T3_Vertebra	thoracic iii vertebra
Transverse_plane	Transverse_Plane	transverse plane
Set_of_phalanges_of_foot	Foot_Phalanx	phalanges of foot
Anterior_cruciate_ligament	Anterior_Cruciate_Ligament	anterior cruciate ligament
Septum_primum	Septum_Primum	septum primum
Common_palmar_digital_artery	Common_Palmar_Digital_Artery	common palmar digital artery
Olfactory_bulb	Olfactory_Bulb	olfactory bulb
Glans_penis	Glans_Penis	glans penis
Neural_crest	Neural_Crest	neural crest
Intermediate_trophoblast_cell	Intermediate_Trophoblast	intermediate type trophoblastic cell
Latissimus_dorsi	Musculus_Latissimus_Dorsi	musculus latissimus dorsi
Heparan_sulfate	Heparan_Sulfate	heparan sulfate
Temporal_vein	Temporal_Vein	temporal vein
Neurilemma	Sheath_of_Schwann	sheath of schwann
Secretory_granule	Secretory_Granule	secretory granule
Intermediate_filament	Intermediate_Filament	intermediate filament
Cytoplasmic_inclusion	Cytoplasmic_Inclusion	cytoplasmic inclusion
Superior_rectal_artery	Superior_Hemorrhoidal_Artery	superior hemorrhoidal artery
Eccrine_sweat_gland	Eccrine_Sweat_Gland	eccrine sweat gland
Vertebral_artery	Vertebral_Artery	vertebral artery
Septum_secundum	Septum_Secundum	septum secundum
Circular_muscle_layer_of_abdominal_part_of_esophagus	Lower_Esophageal_Sphincter	lower esophageal sphincter
Molar_tooth	Molar_Tooth	molar tooth
Cricothyroid_joint	Cricothyroid_Joint	cricothyroid joint
Capillary	Blood_Capillary	blood capillary
Major_salivary_gland	Major_Salivary_Gland	major salivary gland
Anterior_auricular_vein	Anterior_Auricular_Vein	anterior auricular vein
Lymphokine_activated_natural_killer_cell	Lymphokine-Activated_Natural_Killer_Cell	lymphokine activated natural killer cell
Membranous_labyrinth	Membranous_Labyrinth	membranous labyrinth
Caproic_acid	Caproic_Acid	hexanoic acid
Left_subcostal_vein	Left_Subcostal_Vein	left subcostal vein
Semispinalis_capitis	Semispinalis_Capitis	semispinalis capitis
Intestinal_secretion	Intestinal_Secretion	intestinal secretion
Anterior_meningeal_branch_of_anterior_ethmoidal_artery	Anterior_Meningeal_Artery	anterior meningeal artery
Fusiform_cell	Fusiform_Cell	fusiform cell
Tonsillar_ring	Waldeyers_Tonsillar_Ring	waldeyer s tonsillar ring
Foramen_magnum	Foramen_Magnum	foramen magnum
Glandular_cell_of_stomach	Gastric_Glandular_Cell	gastric glandular cell
Temporalis	Temporal_Muscle	temporal muscle
Cell_junction	Cell_Junction	cell junction
Right_testis	Right_Testis	right testis
Ganglion_cell	Ganglion_Cell	ganglion cell
Lactiferous_terminal_ductal_lobular_unit	Terminal_Ductal_Lobular_Unit	tdlu
Obturator_muscle	Obturator_Muscle	obturator muscle
Sulcus_limitans	Sulcus_Limitans	sulcus limitans
Tentorium_cerebelli	Tentorium_Cerebelli	tentorium cerebelli
Internal_thoracic_artery	Internal_Mammary_Artery	internal thoracic artery
Gastrophrenic_ligament	Gastrophrenic_Ligament	gastrophrenic ligament
Peritoneal_macrophage	Peritoneal_Macrophage	peritoneal macrophage
Buccal_salivary_gland	Buccal_Salivary_Gland	buccal salivary gland
Semicircular_duct	Semicircular_Duct	semicircular duct
Left_cerebral_hemisphere	Left_Cerebral_Hemisphere	left cerebral hemisphere
Acromioclavicular_joint	Acromioclavicular_Joint	acromioclavicular joint
Collagen_fiber	Collagen_Fiber	collagen fiber
Cricothyroid_muscle	Cricothyroid_Muscle	cricothyroid muscle
Posterior_parietal_artery	Posterior_Parietal_Artery	posterior parietal artery
Decidual_cell	Decidual_Cell	decidual cell
Femoral_artery	Femoral_Artery	femoral artery
Prostatic_epithelium	Prostatic_Epithelium	prostatic epithelium
Thyrohyoid_ligament	Thyrohyoid_Ligament	thyrohyoid ligament
Cutaneous_vein	Cutaneous_Vein	cutaneous vein
Retroperitoneal_space	Retroperitoneal_Space	retroperitoneal space
Ileocolic_vein	Ileocolic_Vein	ileocolic vein
Subarachnoid_cistern	Subarachnoid_Cistern	subarachnoid cistern
Esophageal_artery	Esophageal_Artery	esophageal artery
Nonmembranous_cytoplasmic_organelle	Nonmembranous_Cytoplasmic_Organelle	nonmembranous cytoplasmic organelle
Bulb_of_hair_follicle	Hair_Bulb	hair bulb
Vitelline_vein	Vitelline_Vein	vitelline vein
Interleukin_12	Therapeutic_Interleukin-12	interleukin iii
Interleukin_2	Interleukin-2	interleukin ii
Gastrocolic_ligament	Gastrocolic_Ligament	gastrocolic ligament
Lacrimal_sac	Lacrimal_Sac	lacrimal sac
Ovarian_vein	Ovarian_Vein	ovarian vein
Gingival_epithelium	Gingival_Epithelium	gingival epithelium
Labial_salivary_gland	Labial_Salivary_Gland	labial salivary gland
Cytoplasmic_organelle	Cytoplasmic_Organelle	cytoplasmic organelle
Pigmented_layer_of_retina	Retinal_Pigment_Epithelium	retinal pigment epithelium
Transfer_ribonucleic_acid	Transfer_RNA	transfer rna
Respiratory_bronchiole	Respiratory_Bronchiole	respiratory bronchiole
Columnar_cell	Columnar_Cell	columnar cell
Central_retinal_artery	Retinal_Artery	retinal artery
Ampullary_crest_of_semicircular_duct	Ampullary_Crest	ampullary crest
Inguinal_lymph_node	Inguinal_Lymph_Node	inguinal lymph node
Surface_of_bone	Bone_Surface	bone surface
Skin_of_abdomen	Abdominal_Skin	abdominal skin
Nucleus_of_brain	Brain_Nucleus	brain nucleus
First_thoracic_vertebra	T1_Vertebra	thoracic i vertebra
Theca_lutein_cell	Theca_Lutein_Cell	theca lutein cell
Columnar_cell_of_endocervix	Endocervical_Columnar_Cell	endocervical columnar cell
Granulosa_lutein_cell	Granulosa_Lutein_Cell	granulosa lutein cell
Macula_densa	Macula_Densa	macula densa
Temporal_fossa	Temporal_Fossa	temporal fossa
Cell_component	Cell_Part	cell component
Taste_bud_cell	Taste_Bud_Cell	taste bud cell
Intrapulmonary_bronchus	Intrapulmonary_Bronchus	intrapulmonary bronchus
Dopaminergic_neuron	Dopaminergic_Cell	dopaminergic cell
Yolk_sac	Yolk_Sac	yolk sac
Crypt_of_Lieberkuhn_of_large_intestine	Large_Intestinal_Crypt_of_the_Lieberkuhn	large intestinal crypt of lieberkuhn
Ciliary_muscle	Ciliary_Muscle	ciliary muscle
Chromophobe_cell	Chromophobe_Cell	chromophobe cell
Delta_cell	Delta_Cell	delta cell
Facial_vein	Facial_Vein	facial vein
Choroidal_fissure	Choroidal_Fissure	choroidal fissure
Umbilical_cord	Umbilical_Cord	umbilical cord
Anterior_spinal_artery	Anterior_Spinal_Artery	anterior spinal artery
Dentate_gyrus_of_hippocampal_formation	Dentate_Gyrus	dentate gyrus
Endodermal_cell	Endoderm_Cell	endodermal cell
Perineal_artery	Perineal_Artery	perineal artery
Posterior_auricular_vein	Posterior_Auricular_Vein	posterior auricular vein
Endocrine_cell	Endocrine_Cell_and_Neuroendocrine_Cell	endocrine cell
Nail_of_toe	Toe_Nail	toe nail
Palatine_bone	Palatine_Bone	palatine bone
Palatine_salivary_gland	Palatine_Salivary_Gland	palatine salivary gland
Goblet_cell	Goblet_Cell	goblet cell
Cervical_nerve	Cervical_Nerve	cervical nerve
Superficial_temporal_vein	Superficial_Temporal_Vein	superficial temporal vein
Collicular_artery	Quadrigeminal_Artery	quadrigeminal artery
Anal_sinus	Anal_Sinus	anal sinus
Nasal_cartilage	Nasal_Cartilage	nasal cartilage
Medial_tarsal_artery	Medial_Tarsal_Artery	medial tarsal artery
Nitrergic_neuron	Nitrergic_Neuron	nitrergic neuron
Lobar_bronchus	Lobar_Bronchus	secondary bronchus
Chest_wall	Chest_Wall	chest wall
Enteric_ganglion	Enteric_Ganglion	enteric ganglion
Axillary_artery	Axillary_Artery	axillary artery
Reticulocyte	Polychromatophilic_Erythrocyte	polychromatophilic erythrocyte
Mucosa_of_upper_lip	Mucosa_of_the_Upper_Lip	mucosa of upper lip
Ulnar_nerve	Ulnar_Nerve	ulnar nerve
Lumbar_vertebra	Lumbar_Vertebra	lumbar vertebra
Epiglottic_cartilage	Epiglottic_Cartilage	epiglottic cartilage
Glial_filament	Glial_Fibrillary_Acidic_Protein	glial fibrillary acidic protein
Totipotent_stem_cell	Totipotent_Stem_Cell	totipotent stem cell
Epithelium_of_respiratory_bronchiole	Respiratory_Bronchiole_Epithelium	respiratory bronchiole epithelium
Falx_cerebelli	Falx_Cerebelli	falx cerebelli
Lacrimal_bone	Lacrimal_Bone	lacrimal bone
Common_hepatic_duct	Hepatic_Duct	hepatic duct
Right_renal_vein	Right_Renal_Vein	right renal vein
Second_lumbar_vertebra	L2_Vertebra	lumbar ii vertebra
Terminal_sulcus	Sulcus_Terminalis	sulcus terminalis
Merkel_cell	Merkel_Cell	merkel cell
Anterior_olfactory_nucleus	Anterior_Olfactory_Nucleus	anterior olfactory nucleus
Endocrine_pancreas	Endocrine_Pancreas	endocrine pancreas
Iliocostalis_thoracis	Iliocostal_Muscle	iliocostalis thoracis
Valve_of_inferior_vena_cava	Eustachian_Valve	eustachian valve
Supramarginal_gyrus	Supramarginal_Gyrus	supramarginal gyrus
Xiphoid_process	Xiphoid_Process	xiphoid process
Pacinian_corpuscle	Vater-Pacini_Corpuscle	pacinian corpuscle
Autonomic_ganglion	Autonomic_Ganglion	autonomic ganglion
Renshaw_cell	Renshaw_Cell	renshaw cell
Cerebral_vein	Cerebral_Vein	cerebral vein
Epithelium_of_paranasal_sinus	Paranasal_Sinus_Epithelium	paranasal sinus epithelium
Skin_of_ankle	Ankle_Skin	ankle skin
Intestinal_mucosa	Intestinal_Mucosa	intestinal mucosa
Cochlear_labyrinth	Cochlear_Labyrinth	cochlear labyrinth
Posterior_choroidal_artery	Posterior_Choroidal_Artery	posterior choroidal artery
Basal_cell_layer_of_epidermis	Rete_Malpighii	stratum germinativum
Paneth_cell	Paneth_Cell	paneth cell
Intercostal_nerve	Intercostal_Nerve	intercostal nerve
Aqueous_humor_of_eyeball	Aqueous_Humor	aqueous humor
Cerebellar_vein	Cerebellar_Vein	cerebellar vein
Sciatic_nerve	Sciatic_Nerve	sciatic nerve
Ovarian_artery	Ovarian_Artery	ovarian artery
APUD_cell	APUD_Cell	apud cell
Hip_joint	Hip_Joint	hip joint
Phalanx_of_finger	Phalanx_of_the_Hand	bone of finger
Capitate	Capitate_Bone	capitate bone
Medial_meniscus	Meniscus_Medialis	medial meniscus
Masseteric_artery	Masseteric_Artery	masseteric artery
Lacrimal_gland	Lacrimal_Gland	lacrimal gland
Hyo_epiglottic_ligament	Hyoepiglottic_Ligament	hyoepiglottic ligament
Perineal_muscle	Perineal_Muscle	perineal muscle
Cerebrospinal_fluid	Cerebrospinal_Fluid	csf
Lingual_tonsil	Lingual_Tonsil	lingual tonsil
Pancreatic_centro_acinar_cell	Pancreatic_Centroacinar_Cell	pancreatic centroacinar cell
Apocrine_sweat_gland	Apocrine_Sweat_Gland	apocrine sweat gland
Inferior_epigastric_vein	Deep_Epigastric_Vein	inferior epigastric vein
Superior_mediastinum	Superior_Mediastinum	superior mediastinum
Body_of_pancreas	Body_of_the_Pancreas	body of pancreas
Umbilical_vein	Umbilical_Vein	umbilical vein
Interlobular_bile_duct	Interlobular_Bile_Duct	interlobular bile duct
Obturator_vein	Obturator_Vein	obturator vein
Gastric_gland	Fundic_Gland	gastric gland
Chemical_synapse	Chemical_Synapse	chemical synapse
Cuboidal_cell	Cuboidal_Cell	cuboidal cell
Gingiva	Gingiva	gum
Mitotic_chromosome	Mitotic_Chromosome	mitotic chromosome
Axosomatic_synapse	Axosomatic_Synapse	axosomatic synapse
Type_IV_taste_bud_cell	Taste_Bud_Basal_Cell	taste bud basal cell
Zona_pellucida	Zona_Pellucida	zona pellucida
Cisterna_chyli	Chyle_Cistern	chyle cistern
Nuclear_pore	Nuclear_Pore	nuclear pore
Intermediate_filament_protein	Intermediate_Filament_Protein	intermediate filament protein
Portal_triad	Portal_Triad	portal triad
Cutaneous_muscle	Cutaneous_Muscle	cutaneous muscle
Lateral_meniscus	Meniscus_Lateralis	lateral meniscus
Smooth_endoplasmic_reticulum	Smooth_Endoplasmic_Reticulum	smooth endoplasmic reticulum